Id,OverallQual,GrLivArea,TotalBsmtSF,1stFlrSF,BsmtFinSF1,2ndFlrSF,GarageCars,YearBuilt,GarageArea
1461,5,896,882.0,896,468.0,0,1.0,1961,730.0
1462,6,1329,1329.0,1329,923.0,0,1.0,1958,312.0
1463,5,1629,928.0,928,791.0,701,2.0,1997,482.0
1464,6,1604,926.0,926,602.0,678,2.0,1998,470.0
1465,8,1280,1280.0,1280,263.0,0,2.0,1992,506.0
1466,6,1655,763.0,763,0.0,892,2.0,1993,440.0
1467,6,1187,1168.0,1187,935.0,0,2.0,1992,420.0
1468,6,1465,789.0,789,0.0,676,2.0,1998,393.0
1469,7,1341,1300.0,1341,637.0,0,2.0,1990,506.0
1470,4,882,882.0,882,804.0,0,2.0,1970,525.0
1471,7,1337,1405.0,1337,1051.0,0,2.0,1999,511.0
1472,6,987,483.0,483,156.0,504,1.0,1971,264.0
1473,5,1092,525.0,525,300.0,567,1.0,1971,320.0
1474,6,1456,855.0,855,514.0,601,2.0,1975,440.0
1475,7,836,836.0,836,0.0,0,1.0,1975,308.0
1476,9,2334,1590.0,1627,0.0,707,3.0,2009,751.0
1477,8,1544,1544.0,1544,0.0,0,3.0,2009,868.0
1478,9,1698,1698.0,1698,110.0,0,3.0,2005,730.0
1479,8,1822,1822.0,1822,28.0,0,3.0,2005,678.0
1480,9,2696,2846.0,2696,1373.0,0,3.0,2003,958.0
1481,8,2250,1671.0,1687,578.0,563,3.0,2002,756.0
1482,8,1370,1370.0,1370,24.0,0,2.0,2006,484.0
1483,6,1324,1324.0,1324,0.0,0,2.0,2005,430.0
1484,7,1145,1145.0,1145,16.0,0,2.0,2006,437.0
1485,7,1374,384.0,744,326.0,630,2.0,2004,400.0
1486,7,1733,847.0,847,0.0,886,2.0,2004,433.0
1487,8,2475,1629.0,1645,0.0,830,3.0,1998,962.0
1488,8,1595,1595.0,1595,0.0,0,3.0,2005,880.0
1489,7,1218,1218.0,1218,0.0,0,2.0,2009,676.0
1490,6,1468,1468.0,1468,1414.0,0,2.0,2005,528.0
1491,7,1659,831.0,831,0.0,828,2.0,2004,484.0
1492,5,1012,816.0,1012,0.0,0,1.0,1920,429.0
1493,6,1494,1208.0,1494,126.0,0,2.0,1974,461.0
1494,8,2349,1231.0,1251,250.0,1098,3.0,1993,762.0
1495,8,2225,1390.0,1402,1129.0,823,3.0,1992,713.0
1496,7,1488,1488.0,1488,1298.0,0,2.0,2004,506.0
1497,7,1680,840.0,840,0.0,840,2.0,2004,588.0
1498,7,1200,600.0,600,280.0,600,2.0,2004,480.0
1499,7,1200,600.0,600,368.0,600,2.0,2004,480.0
1500,6,1236,600.0,600,376.0,636,2.0,2005,480.0
1501,6,1512,756.0,756,466.0,756,2.0,2000,440.0
1502,7,1080,530.0,530,244.0,550,2.0,2003,496.0
1503,8,1418,1642.0,1418,1032.0,0,3.0,2010,852.0
1504,8,1848,975.0,975,484.0,873,2.0,2000,592.0
1505,7,1492,1492.0,1492,833.0,0,2.0,2002,596.0
1506,6,1829,1829.0,1829,506.0,0,2.0,1967,535.0
1507,6,2495,1280.0,1280,1137.0,1215,2.0,1993,660.0
1508,6,1891,1224.0,1287,687.0,604,2.0,1978,678.0
1509,6,1645,715.0,930,329.0,715,2.0,1971,441.0
1510,5,1232,1232.0,1232,698.0,0,2.0,1966,490.0
1511,5,1209,1209.0,1209,1059.0,0,2.0,1966,504.0
1512,5,1510,1510.0,1510,1010.0,0,2.0,1967,517.0
1513,6,1775,533.0,1131,0.0,644,2.0,1964,480.0
1514,5,1728,1728.0,1728,1500.0,0,0.0,1962,0.0
1515,5,2461,1140.0,1929,670.0,532,2.0,1952,400.0
1516,6,1556,782.0,1019,300.0,537,2.0,1949,470.0
1517,6,1128,1080.0,1128,944.0,0,1.0,1966,315.0
1518,5,1604,1604.0,1604,0.0,0,2.0,1958,576.0
1519,7,1480,1480.0,1480,1188.0,0,2.0,2003,620.0
1520,5,1143,1143.0,1143,856.0,0,1.0,1959,308.0
1521,5,1206,1206.0,1206,936.0,0,1.0,1959,312.0
1522,6,1580,1244.0,1580,734.0,0,2.0,1959,440.0
1523,4,1337,832.0,832,0.0,505,1.0,1956,263.0
1524,5,1064,864.0,1064,339.0,0,1.0,1952,318.0
1525,5,972,972.0,972,648.0,0,1.0,1955,305.0
1526,5,988,988.0,988,532.0,0,1.0,1958,264.0
1527,4,985,576.0,985,0.0,0,2.0,1920,676.0
1528,6,1224,816.0,816,481.0,408,1.0,1948,280.0
1529,5,1175,1175.0,1175,588.0,0,2.0,1960,484.0
1530,6,1395,1395.0,1395,717.0,0,2.0,1963,440.0
1531,4,1844,709.0,1157,48.0,687,1.0,1900,240.0
1532,5,936,936.0,936,579.0,0,0.0,1920,0.0
1533,5,1347,1347.0,1347,274.0,0,2.0,1957,551.0
1534,6,1251,827.0,827,0.0,424,1.0,1938,240.0
1535,5,1633,1027.0,1027,780.0,606,1.0,1948,240.0
1536,5,1245,1008.0,1060,176.0,185,1.0,1920,315.0
1537,2,832,678.0,832,0.0,0,2.0,1923,780.0
1538,8,1566,930.0,930,0.0,636,1.0,1900,288.0
1539,8,2268,346.0,1157,0.0,1111,2.0,1890,624.0
1540,5,2256,840.0,1128,0.0,1128,0.0,1910,0.0
1541,6,1470,738.0,868,283.0,602,2.0,1922,624.0
1542,5,1612,988.0,1030,788.0,582,1.0,1950,363.0
1543,7,2068,1108.0,1160,474.0,908,1.0,1922,315.0
1544,4,765,765.0,765,188.0,0,1.0,1925,200.0
1545,6,1132,608.0,608,452.0,524,1.0,1939,240.0
1546,6,1196,572.0,848,264.0,348,2.0,1940,576.0
1547,5,1453,835.0,955,360.0,498,1.0,1942,240.0
1548,6,1416,780.0,780,300.0,636,1.0,1948,312.0
1549,5,1040,528.0,548,276.0,492,2.0,1936,624.0
1550,5,1536,928.0,928,448.0,608,2.0,1930,480.0
1551,6,1068,1124.0,1068,960.0,0,1.0,1923,288.0
1552,4,1962,888.0,888,0.0,1074,2.0,1915,572.0
1553,6,1560,780.0,780,0.0,780,0.0,1912,0.0
1554,6,1324,662.0,662,0.0,662,1.0,1920,180.0
1555,5,1675,1422.0,1675,766.0,0,1.0,1959,365.0
1556,5,1224,689.0,725,0.0,499,1.0,1917,180.0
1557,5,1392,1212.0,1212,1026.0,180,0.0,1915,0.0
1558,6,919,600.0,600,368.0,319,1.0,1940,231.0
1559,4,1884,707.0,942,73.0,942,0.0,1907,0.0
1560,5,1680,856.0,936,736.0,744,2.0,1910,450.0
1561,4,1832,1832.0,1832,704.0,0,0.0,1967,0.0
1562,5,892,864.0,892,240.0,0,1.0,1966,416.0
1563,5,864,864.0,864,775.0,0,1.0,1968,280.0
1564,5,1373,1319.0,1373,1319.0,0,2.0,1978,591.0
1565,5,1440,720.0,720,267.0,720,2.0,1968,480.0
1566,7,1483,1420.0,1483,1092.0,0,2.0,1977,690.0
1567,4,756,660.0,756,0.0,0,2.0,1927,440.0
1568,6,1981,1117.0,1117,964.0,864,2.0,1978,522.0
1569,3,1610,972.0,1052,288.0,558,1.0,1938,480.0
1570,6,1074,663.0,1074,104.0,0,1.0,1950,467.0
1571,4,1531,756.0,1169,192.0,0,1.0,1947,209.0
1572,5,1172,1172.0,1172,954.0,0,1.0,1954,366.0
1573,7,1508,1508.0,1508,1346.0,0,2.0,2009,572.0
1574,5,1298,1250.0,1298,0.0,0,2.0,1964,504.0
1575,7,1433,1433.0,1433,1433.0,0,2.0,1987,528.0
1576,6,1802,946.0,964,860.0,838,4.0,1993,1017.0
1577,7,1222,1222.0,1222,24.0,0,2.0,2010,615.0
1578,6,1445,676.0,831,0.0,614,2.0,1900,484.0
1579,5,965,870.0,965,870.0,0,2.0,1996,580.0
1580,7,1692,878.0,892,353.0,800,2.0,1997,513.0
1581,5,1026,1026.0,1026,198.0,0,1.0,1977,308.0
1582,5,876,876.0,876,480.0,0,2.0,1972,484.0
1583,8,1978,1978.0,1978,1682.0,0,3.0,2003,850.0
1584,7,2098,1040.0,1044,0.0,1054,2.0,1997,621.0
1585,6,848,848.0,848,672.0,0,2.0,2003,420.0
1586,3,640,0.0,640,0.0,0,1.0,1945,240.0
1587,5,992,381.0,992,0.0,0,1.0,1954,319.0
1588,5,1196,1196.0,1196,1070.0,0,1.0,1968,336.0
1589,4,1120,744.0,792,0.0,328,2.0,1948,480.0
1590,6,1096,1008.0,1096,528.0,0,1.0,1975,352.0
1591,4,960,960.0,960,0.0,0,0.0,1958,0.0
1592,5,1296,1107.0,1296,133.0,0,1.0,1924,260.0
1593,6,856,856.0,856,238.0,0,2.0,1939,399.0
1594,4,2650,0.0,862,0.0,1788,0.0,1967,0.0
1595,5,1666,894.0,894,0.0,772,0.0,1931,0.0
1596,7,2133,1528.0,1225,426.0,908,1.0,1941,312.0
1597,5,2177,1032.0,1102,375.0,1075,2.0,1950,484.0
1598,7,1652,423.0,896,343.0,756,2.0,1994,473.0
1599,8,1034,982.0,1034,747.0,0,2.0,1989,598.0
1600,8,1191,1191.0,1191,76.0,0,2.0,1989,531.0
1601,2,540,480.0,540,480.0,0,1.0,1941,200.0
1602,6,1107,629.0,727,308.0,380,1.0,1921,625.0
1603,4,952,756.0,952,0.0,0,1.0,1896,330.0
1604,8,1646,1594.0,1646,1373.0,0,2.0,2004,525.0
1605,8,1916,1049.0,1036,615.0,880,3.0,1998,741.0
1606,6,1285,1243.0,1285,679.0,0,2.0,1977,473.0
1607,6,2048,1958.0,2048,0.0,0,2.0,1976,776.0
1608,7,1346,1336.0,1346,78.0,0,3.0,2008,660.0
1609,7,1214,1214.0,1214,0.0,0,2.0,2009,520.0
1610,5,1444,384.0,744,0.0,700,2.0,2006,400.0
1611,5,1264,1068.0,1264,42.0,0,2.0,1965,528.0
1612,5,1430,1430.0,1430,0.0,0,2.0,2004,624.0
1613,5,1344,1344.0,1344,0.0,0,2.0,1999,686.0
1614,5,945,945.0,945,915.0,0,1.0,1973,253.0
1615,4,1092,546.0,546,176.0,546,0.0,1970,0.0
1616,4,1092,546.0,546,0.0,546,0.0,1970,0.0
1617,4,1092,546.0,546,294.0,546,1.0,1972,286.0
1618,5,874,864.0,874,469.0,0,1.0,1971,352.0
1619,5,833,833.0,833,207.0,0,2.0,1984,495.0
1620,5,2432,1216.0,1216,0.0,1216,2.0,1985,616.0
1621,5,1274,624.0,624,458.0,650,2.0,1991,576.0
1622,5,1479,864.0,864,476.0,615,1.0,1969,275.0
1623,8,1803,1679.0,1803,1341.0,0,2.0,1994,482.0
1624,6,1797,1152.0,1152,944.0,645,2.0,1993,616.0
1625,6,882,882.0,882,564.0,0,1.0,1956,502.0
1626,6,1434,1434.0,1434,844.0,0,2.0,1974,528.0
1627,6,1608,945.0,945,847.0,663,2.0,1997,470.0
1628,8,2283,1008.0,1008,850.0,1275,3.0,2003,632.0
1629,7,1628,384.0,958,284.0,670,2.0,1996,390.0
1630,8,2522,2208.0,2522,1965.0,0,2.0,2004,564.0
1631,8,1478,1418.0,1478,341.0,0,2.0,1998,495.0
1632,8,1734,1587.0,1734,741.0,0,2.0,1995,528.0
1633,7,1382,384.0,751,189.0,631,2.0,1998,396.0
1634,6,1636,952.0,952,476.0,684,2.0,1998,440.0
1635,6,1516,707.0,707,600.0,809,2.0,1994,409.0
1636,6,1190,1181.0,1190,0.0,0,2.0,1993,430.0
1637,5,1934,1122.0,946,400.0,988,2.0,1977,567.0
1638,7,2050,832.0,1154,0.0,896,2.0,1978,529.0
1639,6,1671,1427.0,1671,363.0,0,2.0,1978,484.0
1640,7,2673,1043.0,1539,602.0,1134,2.0,1980,441.0
1641,6,1707,1140.0,1707,832.0,0,2.0,1978,479.0
1642,7,1884,926.0,1016,622.0,868,2.0,2003,581.0
1643,8,1874,1058.0,1058,0.0,816,2.0,2000,588.0
1644,8,1811,972.0,972,225.0,839,2.0,2002,565.0
1645,5,1621,1621.0,1621,1333.0,0,2.0,1975,478.0
1646,6,1116,1116.0,1116,888.0,0,2.0,1974,528.0
1647,7,1193,1176.0,1193,636.0,0,2.0,1975,506.0
1648,5,1180,1180.0,1180,0.0,0,2.0,1970,477.0
1649,5,1050,1043.0,1050,500.0,0,1.0,1971,336.0
1650,4,864,864.0,864,726.0,0,2.0,1970,576.0
1651,4,864,864.0,864,240.0,0,2.0,1971,576.0
1652,6,987,483.0,483,254.0,504,1.0,1973,264.0
1653,6,987,483.0,483,110.0,504,1.0,1972,288.0
1654,6,1548,804.0,804,306.0,744,2.0,1976,440.0
1655,7,1055,1057.0,1055,435.0,0,2.0,1975,440.0
1656,6,1456,855.0,855,389.0,601,2.0,1977,440.0
1657,6,1548,804.0,804,320.0,744,2.0,1978,440.0
1658,6,1456,855.0,855,279.0,601,2.0,1978,440.0
1659,7,836,836.0,836,536.0,0,1.0,1976,345.0
1660,5,1120,864.0,1120,644.0,0,2.0,1966,656.0
1661,9,2772,1776.0,1794,1360.0,978,3.0,2007,754.0
1662,9,2690,1365.0,1365,986.0,1325,3.0,2009,864.0
1663,9,2020,2020.0,2020,1232.0,0,3.0,2008,896.0
1664,10,2674,2630.0,2674,2288.0,0,3.0,2007,762.0
1665,9,1736,1736.0,1736,0.0,0,3.0,2008,834.0
1666,8,1782,1782.0,1782,1531.0,0,3.0,2004,932.0
1667,8,2520,1508.0,1508,1230.0,1012,3.0,2007,640.0
1668,9,1743,1739.0,1743,1015.0,0,3.0,2008,927.0
1669,9,1531,1504.0,1531,1037.0,0,3.0,2006,700.0
1670,9,1808,1774.0,1808,1142.0,0,3.0,2008,850.0
1671,7,1760,1760.0,1760,1262.0,0,2.0,2003,583.0
1672,9,2452,2452.0,2452,1972.0,0,3.0,2003,886.0
1673,8,2400,1082.0,1105,0.0,1295,3.0,2003,730.0
1674,8,1606,1598.0,1606,0.0,0,3.0,2006,871.0
1675,6,1358,1358.0,1358,836.0,0,2.0,2005,484.0
1676,6,1306,1306.0,1306,881.0,0,2.0,2005,624.0
1677,7,1358,1350.0,1358,876.0,0,2.0,2007,484.0
1678,10,2492,2492.0,2492,2146.0,0,3.0,2004,949.0
1679,8,2200,2200.0,2200,1557.0,0,3.0,2003,685.0
1680,9,1884,1884.0,1884,800.0,0,2.0,2008,649.0
1681,9,1456,1451.0,1456,0.0,0,2.0,2008,539.0
1682,8,1712,1712.0,1712,1196.0,0,3.0,2002,701.0
1683,7,1405,1405.0,1405,0.0,0,2.0,2003,478.0
1684,7,1456,728.0,728,0.0,728,2.0,2005,390.0
1685,6,1490,745.0,745,0.0,745,2.0,2005,392.0
1686,7,1220,1220.0,1220,16.0,0,2.0,2005,397.0
1687,7,1374,384.0,744,0.0,630,2.0,2004,400.0
1688,7,1630,868.0,868,0.0,762,2.0,2004,436.0
1689,7,1594,846.0,846,0.0,748,2.0,2004,434.0
1690,7,1489,782.0,806,652.0,683,2.0,2003,400.0
1691,7,1342,698.0,698,494.0,644,2.0,2003,393.0
1692,8,2004,870.0,878,651.0,1126,3.0,2002,644.0
1693,7,1374,384.0,744,241.0,630,2.0,2004,400.0
1694,6,1514,794.0,819,683.0,695,2.0,2000,394.0
1695,7,1430,384.0,774,0.0,656,2.0,1999,400.0
1696,7,2312,1177.0,1223,913.0,1089,3.0,1999,658.0
1697,7,1430,384.0,774,0.0,656,2.0,1999,410.0
1698,8,2687,1455.0,1466,1173.0,1221,3.0,2000,810.0
1699,8,2063,2024.0,2063,236.0,0,3.0,1994,815.0
1700,7,2061,1070.0,1094,816.0,967,2.0,1995,647.0
1701,8,2232,1173.0,1215,624.0,1017,2.0,1993,623.0
1702,8,1696,1696.0,1696,0.0,0,3.0,2008,972.0
1703,8,1658,1614.0,1658,0.0,0,3.0,2008,726.0
1704,8,1702,1702.0,1702,1294.0,0,3.0,2007,844.0
1705,8,1432,1422.0,1432,379.0,0,2.0,2006,492.0
1706,9,2490,2458.0,2490,2158.0,0,3.0,2005,795.0
1707,7,1436,1436.0,1436,0.0,0,2.0,2008,529.0
1708,7,1402,1402.0,1402,0.0,0,2.0,2008,625.0
1709,9,1530,1530.0,1530,0.0,0,3.0,2007,984.0
1710,8,1448,1372.0,1448,24.0,0,2.0,2006,692.0
1711,8,1795,900.0,909,682.0,886,3.0,2006,782.0
1712,8,1836,1836.0,1836,0.0,0,2.0,2008,517.0
1713,7,1662,1652.0,1662,1430.0,0,3.0,2006,711.0
1714,7,1553,1553.0,1553,771.0,0,2.0,2003,588.0
1715,7,1653,812.0,812,410.0,841,2.0,2003,628.0
1716,7,1218,1218.0,1218,0.0,0,2.0,2007,576.0
1717,7,1141,1141.0,1141,54.0,0,2.0,2006,484.0
1718,6,1158,1158.0,1158,0.0,0,0.0,2004,0.0
1719,7,1812,835.0,871,0.0,941,2.0,2004,478.0
1720,8,1512,1512.0,1512,516.0,0,3.0,2004,845.0
1721,7,1114,1114.0,1114,0.0,0,2.0,2004,576.0
1722,5,1114,1114.0,1114,0.0,0,0.0,2004,0.0
1723,5,1114,1114.0,1114,836.0,0,2.0,2003,576.0
1724,7,1450,1450.0,1450,0.0,0,3.0,2008,788.0
1725,7,2122,913.0,913,637.0,1209,2.0,1996,559.0
1726,6,1730,816.0,833,52.0,897,2.0,1992,528.0
1727,6,1332,1332.0,1332,0.0,0,2.0,1990,542.0
1728,7,1540,754.0,754,36.0,786,2.0,1994,495.0
1729,6,1400,676.0,698,331.0,702,2.0,1986,465.0
1730,6,1882,0.0,964,0.0,918,2.0,1981,612.0
1731,5,980,980.0,980,68.0,0,2.0,1962,400.0
1732,5,864,864.0,864,660.0,0,2.0,1961,732.0
1733,5,864,864.0,864,864.0,0,1.0,1961,440.0
1734,5,1020,1024.0,1020,544.0,0,1.0,1965,288.0
1735,5,912,912.0,912,624.0,0,1.0,1963,300.0
1736,5,912,912.0,912,140.0,0,1.0,1962,252.0
1737,8,2014,2014.0,2014,1733.0,0,3.0,1980,864.0
1738,7,1755,975.0,975,601.0,780,2.0,1991,524.0
1739,7,3005,1376.0,1376,0.0,1629,3.0,2004,704.0
1740,6,1726,1726.0,1726,0.0,0,2.0,2008,561.0
1741,6,1256,1145.0,1256,962.0,0,2.0,2008,641.0
1742,6,1512,756.0,756,507.0,756,2.0,2000,440.0
1743,7,1452,691.0,713,549.0,739,2.0,1999,506.0
1744,8,1694,1694.0,1694,1252.0,0,2.0,1977,642.0
1745,7,1740,1740.0,1740,121.0,0,2.0,1981,540.0
1746,8,2499,392.0,1487,0.0,1012,2.0,1976,527.0
1747,7,2067,752.0,1285,560.0,782,2.0,1974,784.0
1748,6,2640,932.0,1271,0.0,1369,2.0,1967,515.0
1749,5,1336,1288.0,1336,553.0,0,2.0,1969,502.0
1750,6,1216,1216.0,1216,955.0,0,1.0,1969,336.0
1751,7,2288,908.0,1316,432.0,972,2.0,1977,520.0
1752,5,864,864.0,864,648.0,0,1.0,1967,312.0
1753,5,1568,1568.0,1568,0.0,0,2.0,1967,440.0
1754,7,2061,1165.0,1165,698.0,896,2.0,1974,498.0
1755,6,1320,1232.0,1320,962.0,0,2.0,1971,495.0
1756,4,894,894.0,894,734.0,0,2.0,1960,396.0
1757,5,864,864.0,864,403.0,0,1.0,1959,308.0
1758,4,1362,1040.0,1362,775.0,0,3.0,1957,768.0
1759,5,1728,1048.0,1728,625.0,0,2.0,1956,576.0
1760,5,1313,1313.0,1313,310.0,0,2.0,1961,610.0
1761,5,1292,1292.0,1292,998.0,0,2.0,1964,520.0
1762,5,2140,744.0,825,388.0,1315,2.0,1965,549.0
1763,6,1576,1208.0,1576,568.0,0,2.0,1961,368.0
1764,5,960,960.0,960,100.0,0,1.0,1955,330.0
1765,6,1691,1680.0,1691,1173.0,0,2.0,1967,550.0
1766,6,1453,1453.0,1453,1312.0,0,2.0,1961,530.0
1767,6,1567,1562.0,1567,1387.0,0,2.0,1966,542.0
1768,5,1144,1169.0,1144,856.0,0,1.0,1956,286.0
1769,7,1329,1329.0,1329,544.0,0,2.0,1960,441.0
1770,6,988,988.0,988,708.0,0,1.0,1959,297.0
1771,5,1202,1202.0,1202,435.0,0,1.0,1956,304.0
1772,5,1382,1382.0,1382,172.0,0,1.0,1955,350.0
1773,4,1200,1200.0,1200,155.0,0,1.0,1956,294.0
1774,5,1866,1866.0,1866,0.0,0,2.0,1958,495.0
1775,6,1062,1062.0,1062,490.0,0,1.0,1954,297.0
1776,5,1112,631.0,1112,308.0,0,2.0,1951,480.0
1777,5,793,793.0,793,700.0,0,1.0,1945,240.0
1778,5,1031,1031.0,1031,931.0,0,1.0,1952,230.0
1779,5,1210,0.0,1210,0.0,0,1.0,1953,616.0
1780,7,1527,699.0,801,699.0,726,2.0,1948,410.0
1781,5,1200,1200.0,1200,390.0,0,1.0,1950,246.0
1782,3,792,792.0,792,0.0,0,1.0,1958,366.0
1783,5,1352,676.0,676,0.0,676,2.0,1939,720.0
1784,4,1039,405.0,717,0.0,322,1.0,1900,281.0
1785,5,1078,1054.0,1078,0.0,0,1.0,1925,264.0
1786,4,2377,1313.0,1313,0.0,0,2.0,1915,528.0
1787,7,1690,560.0,930,0.0,760,2.0,1910,624.0
1788,2,599,416.0,599,0.0,0,0.0,1940,0.0
1789,5,846,720.0,846,0.0,0,2.0,1920,576.0
1790,3,725,630.0,725,0.0,0,1.0,1890,320.0
1791,6,2544,1248.0,1248,0.0,1296,3.0,1969,907.0
1792,6,1380,1380.0,1380,384.0,0,1.0,1963,364.0
1793,6,1040,1040.0,1040,872.0,0,2.0,1967,480.0
1794,6,951,951.0,951,745.0,0,2.0,1958,480.0
1795,6,1105,1105.0,1105,546.0,0,1.0,1957,308.0
1796,6,1142,160.0,1142,0.0,0,1.0,1958,384.0
1797,6,1133,795.0,765,621.0,368,2.0,1950,900.0
1798,5,1041,1041.0,1041,0.0,0,1.0,1958,294.0
1799,5,732,732.0,732,630.0,0,1.0,1952,240.0
1800,5,1183,528.0,1183,433.0,0,1.0,1959,288.0
1801,4,1461,832.0,832,0.0,629,1.0,1949,384.0
1802,6,1495,864.0,1064,120.0,0,2.0,1948,576.0
1803,6,1806,780.0,993,0.0,813,2.0,1964,483.0
1804,5,941,941.0,941,941.0,0,2.0,1978,564.0
1805,6,1045,1045.0,1045,826.0,0,1.0,1963,264.0
1806,6,1378,901.0,861,0.0,517,1.0,1935,162.0
1807,6,1944,972.0,972,633.0,972,2.0,1910,324.0
1808,5,1306,240.0,810,0.0,496,2.0,1910,472.0
1809,5,1464,504.0,764,0.0,700,0.0,1910,0.0
1810,5,1558,690.0,868,421.0,690,2.0,1939,400.0
1811,4,1701,600.0,1101,0.0,600,0.0,1920,0.0
1812,5,1447,801.0,801,0.0,646,0.0,1910,0.0
1813,5,1328,768.0,768,384.0,560,1.0,1950,308.0
1814,4,861,861.0,861,0.0,0,2.0,1920,288.0
1815,2,612,0.0,612,0.0,0,1.0,1940,308.0
1816,5,792,624.0,792,0.0,0,1.0,1923,287.0
1817,4,1510,677.0,833,0.0,677,2.0,1910,720.0
1818,6,2007,917.0,1090,0.0,917,1.0,1900,357.0
1819,6,1288,624.0,664,0.0,624,1.0,1917,280.0
1820,4,816,624.0,816,0.0,0,0.0,1910,0.0
1821,6,1480,972.0,1044,0.0,0,1.0,1920,207.0
1822,6,1521,741.0,780,0.0,741,3.0,1910,640.0
1823,3,797,245.0,797,0.0,0,0.0,1900,0.0
1824,6,1432,1022.0,1432,0.0,0,1.0,1923,216.0
1825,5,1654,297.0,1001,0.0,653,1.0,1930,336.0
1826,5,1142,468.0,822,220.0,320,1.0,1924,320.0
1827,5,995,960.0,995,0.0,0,1.0,1925,264.0
1828,5,1582,952.0,994,273.0,588,1.0,1938,250.0
1829,5,1072,1072.0,1072,134.0,0,5.0,1925,1184.0
1830,6,1768,1048.0,1048,0.0,720,2.0,1915,576.0
1831,7,1944,672.0,1272,0.0,672,1.0,1915,216.0
1832,5,2128,1040.0,1088,0.0,1040,0.0,1922,0.0
1833,6,1930,720.0,1146,522.0,784,1.0,1927,316.0
1834,6,1427,483.0,741,0.0,686,1.0,1915,379.0
1835,7,1864,1020.0,978,169.0,886,0.0,1902,0.0
1836,6,1666,1204.0,1204,0.0,462,1.0,1927,384.0
1837,4,892,858.0,892,749.0,0,0.0,1923,0.0
1838,6,1403,698.0,754,276.0,649,1.0,1915,308.0
1839,4,704,560.0,704,0.0,0,1.0,1946,220.0
1840,5,1200,1200.0,1200,1200.0,0,0.0,1987,0.0
1841,5,1152,1152.0,1152,1152.0,0,1.0,1978,252.0
1842,5,1112,585.0,687,0.0,425,1.0,1934,226.0
1843,5,1052,1052.0,1052,527.0,0,1.0,1967,668.0
1844,6,1034,456.0,1034,456.0,0,2.0,1978,504.0
1845,5,1774,552.0,904,0.0,611,1.0,1961,384.0
1846,6,1138,1138.0,1138,588.0,0,2.0,1960,480.0
1847,5,2071,825.0,2071,0.0,0,1.0,1956,336.0
1848,2,660,0.0,660,0.0,0,0.0,1947,0.0
1849,4,1383,0.0,1383,0.0,0,2.0,1954,498.0
1850,5,1073,1073.0,1073,257.0,0,1.0,1956,340.0
1851,6,1639,747.0,892,342.0,747,1.0,1946,240.0
1852,5,1089,1089.0,1089,173.0,0,1.0,1954,252.0
1853,5,1049,1049.0,1049,552.0,0,1.0,1984,266.0
1854,7,1061,1054.0,1061,460.0,0,2.0,1990,462.0
1855,6,1338,520.0,1338,70.0,0,2.0,1983,576.0
1856,7,1879,1079.0,1079,474.0,800,2.0,1993,473.0
1857,5,2016,0.0,1288,0.0,728,2.0,1880,576.0
1858,5,2228,0.0,1114,0.0,1114,2.0,1979,720.0
1859,5,1535,0.0,1535,0.0,0,2.0,1979,400.0
1860,5,1229,1094.0,1229,1094.0,0,2.0,1979,672.0
1861,5,1513,0.0,1513,0.0,0,2.0,1979,400.0
1862,7,2787,1168.0,1168,820.0,1619,4.0,2000,820.0
1863,7,2787,1168.0,1168,820.0,1619,4.0,2000,820.0
1864,7,2787,1168.0,1168,820.0,1619,4.0,2000,820.0
1865,9,1680,1555.0,1680,1021.0,0,3.0,2009,1138.0
1866,9,1720,1720.0,1720,1104.0,0,3.0,2008,846.0
1867,8,1468,1468.0,1468,0.0,0,3.0,2008,904.0
1868,8,1838,1838.0,1838,1359.0,0,2.0,2007,524.0
1869,7,1290,1282.0,1290,902.0,0,2.0,2007,662.0
1870,8,1254,1254.0,1254,872.0,0,3.0,2008,810.0
1871,8,1498,1498.0,1498,24.0,0,3.0,2005,844.0
1872,6,1422,704.0,704,0.0,718,2.0,2005,440.0
1873,7,1759,1449.0,944,800.0,815,2.0,1992,525.0
1874,5,990,990.0,990,755.0,0,1.0,1994,440.0
1875,7,1463,1463.0,1463,950.0,0,2.0,1998,539.0
1876,6,1772,928.0,928,606.0,844,2.0,1998,492.0
1877,7,1444,1431.0,1444,1259.0,0,2.0,2002,577.0
1878,7,1492,1492.0,1492,24.0,0,2.0,2001,608.0
1879,5,907,907.0,907,625.0,0,1.0,1978,343.0
1880,5,914,914.0,914,710.0,0,2.0,1979,444.0
1881,7,1611,1569.0,1611,1234.0,0,3.0,2002,1231.0
1882,8,2184,1068.0,1068,0.0,1116,2.0,2003,570.0
1883,7,1725,840.0,840,0.0,885,2.0,2002,550.0
1884,7,1870,944.0,944,0.0,926,2.0,2001,608.0
1885,8,1513,1462.0,1513,1246.0,0,2.0,1999,521.0
1886,8,1828,1822.0,1828,1360.0,0,2.0,2002,523.0
1887,7,1417,1417.0,1417,1111.0,0,2.0,1997,511.0
1888,8,1602,1578.0,1602,1478.0,0,3.0,2007,810.0
1889,6,1396,608.0,608,0.0,788,2.0,2007,440.0
1890,4,1149,1014.0,1149,399.0,0,1.0,1960,544.0
1891,6,1072,547.0,1072,547.0,0,2.0,2005,525.0
1892,4,876,876.0,876,332.0,0,1.0,1959,320.0
1893,5,1368,1078.0,1368,1078.0,0,1.0,1950,195.0
1894,5,1678,1678.0,1678,0.0,0,0.0,1959,0.0
1895,5,1560,1150.0,1560,546.0,0,1.0,1956,313.0
1896,5,1298,720.0,854,626.0,444,1.0,1941,256.0
1897,5,1268,832.0,832,832.0,436,1.0,1938,250.0
1898,6,1242,583.0,647,0.0,595,1.0,1935,180.0
1899,6,1232,816.0,1232,0.0,0,2.0,1916,440.0
1900,7,1228,600.0,628,0.0,600,1.0,1918,215.0
1901,5,1567,840.0,840,728.0,727,2.0,1940,440.0
1902,5,1273,1273.0,1273,793.0,0,1.0,1960,307.0
1903,7,2480,920.0,1240,246.0,1240,2.0,1940,400.0
1904,5,1112,1112.0,1112,154.0,0,1.0,1954,390.0
1905,6,1561,1561.0,1561,65.0,0,2.0,1960,463.0
1906,5,1523,1067.0,986,312.0,537,1.0,1949,295.0
1907,6,1906,1310.0,1906,784.0,0,2.0,1954,576.0
1908,6,1032,516.0,516,0.0,516,2.0,1980,452.0
1909,6,1229,561.0,561,471.0,668,2.0,1980,462.0
1910,6,1229,561.0,561,0.0,668,2.0,1980,462.0
1911,6,1982,572.0,1182,454.0,800,2.0,1986,501.0
1912,7,2365,1803.0,2365,803.0,0,2.0,1971,551.0
1913,5,2168,760.0,928,0.0,928,2.0,1900,576.0
1914,4,572,572.0,572,0.0,0,1.0,1925,200.0
1915,8,1648,1596.0,1648,1476.0,0,2.0,2007,482.0
1916,2,810,0.0,810,0.0,0,1.0,1910,280.0
1917,8,2052,1107.0,1040,445.0,1012,3.0,2000,642.0
1918,6,926,902.0,926,767.0,0,1.0,1977,351.0
1919,6,1287,957.0,1287,841.0,0,2.0,1977,541.0
1920,5,1595,1582.0,1595,55.0,0,2.0,1991,672.0
1921,9,2036,2190.0,2036,1758.0,0,3.0,2008,780.0
1922,9,1641,1641.0,1641,1115.0,0,3.0,2008,885.0
1923,6,2237,712.0,1375,462.0,862,2.0,1980,440.0
1924,7,1479,1645.0,1479,904.0,0,2.0,1987,578.0
1925,7,2014,912.0,1072,0.0,942,2.0,2003,486.0
1926,9,1978,1978.0,1978,1640.0,0,3.0,2007,920.0
1927,5,1008,1008.0,1008,532.0,0,1.0,1968,384.0
1928,5,1404,1188.0,1404,594.0,0,2.0,1969,504.0
1929,5,796,796.0,796,720.0,0,1.0,1972,336.0
1930,6,1091,384.0,1091,114.0,0,1.0,1993,429.0
1931,5,883,828.0,883,718.0,0,2.0,1992,698.0
1932,5,1287,624.0,624,330.0,663,2.0,1992,440.0
1933,5,1632,784.0,784,496.0,848,2.0,1969,898.0
1934,6,1604,926.0,926,706.0,678,2.0,1997,470.0
1935,6,1470,680.0,680,476.0,790,2.0,1995,420.0
1936,6,1604,926.0,926,851.0,678,2.0,1998,472.0
1937,6,1636,916.0,916,138.0,720,2.0,1996,386.0
1938,5,1384,1348.0,1384,450.0,0,2.0,1996,404.0
1939,8,1682,1664.0,1682,656.0,0,2.0,1997,528.0
1940,8,1280,1280.0,1280,0.0,0,2.0,1992,506.0
1941,6,1633,932.0,932,0.0,701,2.0,1998,460.0
1942,6,1709,836.0,851,504.0,858,2.0,1991,416.0
1943,8,1337,1337.0,1337,319.0,0,2.0,1989,462.0
1944,8,2500,1168.0,1168,16.0,1332,3.0,2005,683.0
1945,9,1884,1884.0,1884,1337.0,0,3.0,2004,670.0
1946,6,1474,1632.0,1474,0.0,0,2.0,1952,495.0
1947,9,1710,1710.0,1710,1034.0,0,2.0,2007,557.0
1948,6,1488,1488.0,1488,0.0,0,2.0,1950,738.0
1949,7,1688,1675.0,1688,983.0,0,2.0,1988,528.0
1950,7,1260,1260.0,1260,747.0,0,2.0,1983,598.0
1951,7,2064,2048.0,2064,1206.0,0,2.0,1978,550.0
1952,7,1782,1782.0,1782,864.0,0,2.0,1979,551.0
1953,6,1211,1211.0,1211,890.0,0,2.0,1976,461.0
1954,7,2044,738.0,1277,0.0,767,2.0,1980,489.0
1955,5,1308,720.0,720,280.0,588,2.0,1969,484.0
1956,7,2840,1420.0,1420,988.0,1420,4.0,1978,1314.0
1957,6,1444,1444.0,1444,0.0,0,2.0,1976,473.0
1958,8,2340,1236.0,1236,1023.0,1104,3.0,1996,787.0
1959,5,1792,896.0,896,0.0,896,2.0,1974,480.0
1960,4,936,936.0,936,252.0,0,1.0,1969,288.0
1961,5,864,864.0,864,119.0,0,2.0,1971,576.0
1962,6,987,483.0,483,458.0,504,1.0,1973,264.0
1963,6,987,483.0,483,483.0,504,1.0,1972,352.0
1964,5,1302,630.0,630,350.0,672,1.0,1972,264.0
1965,6,1456,855.0,855,286.0,601,2.0,1975,460.0
1966,7,1055,1055.0,1055,378.0,0,2.0,1977,440.0
1967,8,1582,1582.0,1582,1012.0,0,3.0,2007,905.0
1968,8,2464,2418.0,2464,1728.0,0,3.0,2007,650.0
1969,9,1950,1950.0,1950,1375.0,0,3.0,2007,706.0
1970,9,2748,1850.0,1850,1420.0,898,3.0,2006,850.0
1971,10,2790,1620.0,1632,1082.0,1158,4.0,2005,1150.0
1972,9,2331,1414.0,1414,1249.0,917,3.0,2005,1003.0
1973,8,2088,948.0,948,40.0,1140,3.0,2007,656.0
1974,8,2332,1148.0,1170,856.0,1162,3.0,2004,756.0
1975,10,2470,2535.0,2470,2257.0,0,3.0,2003,789.0
1976,8,1575,1603.0,1575,1149.0,0,3.0,2003,732.0
1977,8,2649,1479.0,1515,1075.0,1134,3.0,2001,746.0
1978,8,2690,1765.0,1804,0.0,886,3.0,2003,795.0
1979,9,1866,1858.0,1866,372.0,0,3.0,2008,870.0
1980,7,1367,1367.0,1367,20.0,0,2.0,2005,484.0
1981,9,1800,1800.0,1800,1204.0,0,3.0,2007,944.0
1982,8,1342,1342.0,1342,846.0,0,2.0,2006,550.0
1983,8,1342,1342.0,1342,24.0,0,2.0,2006,550.0
1984,7,1626,764.0,764,0.0,862,2.0,2003,474.0
1985,7,1455,1415.0,1455,1073.0,0,3.0,2003,644.0
1986,7,1576,1393.0,1576,1087.0,0,3.0,2004,668.0
1987,7,1246,1146.0,1246,0.0,0,2.0,2007,428.0
1988,6,1515,789.0,813,0.0,702,2.0,2004,393.0
1989,7,1720,840.0,840,0.0,880,2.0,2002,400.0
1990,7,1986,847.0,847,0.0,1139,2.0,2003,434.0
1991,7,1358,1350.0,1358,876.0,0,2.0,2007,484.0
1992,7,1892,982.0,1008,544.0,884,2.0,2000,431.0
1993,7,1414,707.0,707,0.0,707,2.0,2002,403.0
1994,7,2322,1037.0,1037,870.0,1285,2.0,1999,400.0
1995,7,1651,831.0,873,0.0,778,2.0,1999,450.0
1996,8,2199,1173.0,1182,0.0,1017,2.0,1997,516.0
1997,9,2172,1519.0,1533,0.0,639,3.0,2000,687.0
1998,8,2006,1982.0,2006,1660.0,0,3.0,1998,938.0
1999,7,2125,1064.0,1064,851.0,1061,2.0,1996,576.0
2000,8,2501,1242.0,1251,0.0,1250,3.0,1995,751.0
2001,7,2197,1080.0,1108,228.0,1089,3.0,1993,783.0
2002,7,1578,1578.0,1578,1096.0,0,3.0,2006,642.0
2003,8,1861,1341.0,1341,0.0,520,3.0,2007,851.0
2004,8,1874,955.0,955,729.0,919,3.0,2007,880.0
2005,8,1460,1460.0,1460,666.0,0,2.0,2006,480.0
2006,8,1372,1363.0,1372,24.0,0,2.0,2007,588.0
2007,8,1660,1660.0,1660,0.0,0,3.0,2007,660.0
2008,7,1218,1218.0,1218,902.0,0,2.0,2007,462.0
2009,6,1696,835.0,835,80.0,861,2.0,2003,542.0
2010,7,1663,835.0,835,0.0,828,2.0,2003,478.0
2011,6,1175,1175.0,1175,80.0,0,0.0,2005,0.0
2012,7,1162,1162.0,1162,0.0,0,2.0,2007,483.0
2013,6,1609,754.0,754,362.0,855,2.0,1995,525.0
2014,6,1680,886.0,886,602.0,794,2.0,1993,474.0
2015,7,1657,832.0,832,537.0,825,2.0,1994,483.0
2016,6,1677,827.0,827,472.0,850,2.0,2001,627.0
2017,7,1737,836.0,844,397.0,893,2.0,1992,506.0
2018,5,984,984.0,984,53.0,0,1.0,1963,384.0
2019,5,864,864.0,864,764.0,0,1.0,1961,420.0
2020,5,890,890.0,890,890.0,0,1.0,1968,308.0
2021,5,864,864.0,864,489.0,0,1.0,1963,276.0
2022,6,1430,1430.0,1430,800.0,0,2.0,1974,484.0
2023,5,1641,1001.0,1001,190.0,640,2.0,1972,490.0
2024,6,2683,930.0,1364,704.0,1319,2.0,1990,473.0
2025,9,2786,1848.0,1827,520.0,959,2.0,1993,636.0
2026,7,1245,1235.0,1245,24.0,0,2.0,2004,495.0
2027,6,1200,600.0,600,390.0,600,2.0,2005,480.0
2028,7,1392,689.0,703,0.0,689,2.0,2007,540.0
2029,6,1549,744.0,757,550.0,792,2.0,1999,440.0
2030,9,1638,1614.0,1638,1027.0,0,2.0,2000,495.0
2031,9,1310,1310.0,1310,1004.0,0,2.0,2001,545.0
2032,9,1419,1419.0,1419,964.0,0,2.0,2001,588.0
2033,9,1557,1557.0,1557,1141.0,0,2.0,1999,484.0
2034,7,1404,672.0,684,600.0,720,2.0,1999,462.0
2035,7,1789,858.0,872,681.0,917,2.0,2001,546.0
2036,8,1586,960.0,962,612.0,624,2.0,1999,480.0
2037,8,1607,960.0,962,813.0,645,2.0,1999,480.0
2038,10,2393,970.0,1469,128.0,924,2.0,1998,846.0
2039,8,1239,1230.0,1239,560.0,0,2.0,1995,477.0
2040,9,2944,994.0,1599,410.0,1345,3.0,1977,864.0
2041,8,1671,1426.0,1671,1044.0,0,2.0,1976,550.0
2042,7,1812,952.0,952,0.0,860,2.0,2002,469.0
2043,6,1427,1427.0,1427,828.0,0,2.0,1969,516.0
2044,6,1740,1740.0,1740,301.0,0,2.0,1968,512.0
2045,7,1620,1620.0,1620,603.0,0,2.0,1967,578.0
2046,5,1625,1625.0,1625,0.0,0,2.0,1965,484.0
2047,5,1464,732.0,732,732.0,732,2.0,1968,470.0
2048,5,925,912.0,925,260.0,0,2.0,1965,576.0
2049,5,1728,1728.0,1728,0.0,0,2.0,1965,576.0
2050,7,1670,825.0,845,583.0,825,2.0,1971,464.0
2051,5,1014,0.0,1014,0.0,0,1.0,1956,267.0
2052,5,1114,1114.0,1114,0.0,0,2.0,1961,451.0
2053,5,1118,1118.0,1118,528.0,0,1.0,1960,264.0
2054,4,906,348.0,453,120.0,453,1.0,1937,231.0
2055,5,1496,1296.0,1496,658.0,0,2.0,1960,450.0
2056,5,1337,572.0,1337,32.0,0,1.0,1950,264.0
2057,5,1036,1036.0,1036,531.0,0,1.0,1953,312.0
2058,6,1988,1104.0,1104,575.0,884,2.0,1966,480.0
2059,5,1176,1176.0,1176,621.0,0,1.0,1957,292.0
2060,5,1440,1248.0,1440,1053.0,0,1.0,1959,480.0
2061,6,1570,1395.0,1570,958.0,0,2.0,1958,441.0
2062,5,1104,1104.0,1104,774.0,0,1.0,1956,384.0
2063,5,882,720.0,882,148.0,0,1.0,1952,240.0
2064,5,1152,1152.0,1152,500.0,0,2.0,1953,636.0
2065,5,950,984.0,950,624.0,0,2.0,1953,400.0
2066,6,1790,998.0,1790,0.0,0,2.0,1957,540.0
2067,5,1764,0.0,1764,0.0,0,1.0,1957,301.0
2068,5,1824,1824.0,1824,0.0,0,2.0,1957,484.0
2069,4,869,0.0,869,0.0,0,1.0,1948,390.0
2070,5,1159,747.0,747,0.0,412,1.0,1925,288.0
2071,4,672,672.0,672,0.0,0,1.0,1940,308.0
2072,5,1436,892.0,1254,0.0,182,4.0,1922,1488.0
2073,5,1044,912.0,1044,744.0,0,2.0,1968,372.0
2074,7,1312,1312.0,1312,637.0,0,2.0,1958,495.0
2075,6,1081,1081.0,1081,697.0,0,1.0,1960,401.0
2076,5,876,876.0,876,432.0,0,2.0,1951,576.0
2077,5,1256,1256.0,1256,476.0,0,1.0,1959,311.0
2078,5,1027,1027.0,1027,520.0,0,1.0,1962,299.0
2079,6,1320,768.0,819,315.0,501,2.0,1948,576.0
2080,6,984,936.0,984,0.0,0,1.0,1954,280.0
2081,6,1278,854.0,854,673.0,424,1.0,1954,240.0
2082,5,1800,1800.0,1800,0.0,0,0.0,1961,0.0
2083,5,1588,768.0,1024,370.0,564,2.0,1955,480.0
2084,5,825,825.0,825,0.0,0,1.0,1954,350.0
2085,5,1117,1117.0,1117,0.0,0,1.0,1963,264.0
2086,6,1133,192.0,1133,96.0,0,1.0,2008,308.0
2087,5,1323,780.0,948,0.0,375,2.0,1948,400.0
2088,5,1360,680.0,680,0.0,680,1.0,1910,330.0
2089,5,672,672.0,672,0.0,0,1.0,1940,256.0
2090,6,1456,728.0,728,0.0,728,1.0,1915,308.0
2091,4,1594,828.0,828,0.0,658,0.0,1910,0.0
2092,4,1656,801.0,1095,0.0,561,2.0,1940,440.0
2093,5,1740,936.0,960,360.0,780,1.0,1920,225.0
2094,7,1027,931.0,1027,0.0,0,0.0,1920,0.0
2095,6,1436,884.0,884,590.0,552,2.0,1940,828.0
2096,5,899,481.0,899,0.0,0,1.0,1910,200.0
2097,5,1080,684.0,684,0.0,396,0.0,1890,0.0
2098,5,1499,904.0,904,445.0,595,3.0,1946,869.0
2099,2,407,407.0,407,0.0,0,1.0,1946,297.0
2100,3,1588,448.0,1588,0.0,0,0.0,1949,0.0
2101,5,1627,797.0,830,0.0,797,2.0,1900,420.0
2102,7,1450,624.0,730,116.0,720,1.0,1920,288.0
2103,5,1017,346.0,709,0.0,308,1.0,1900,308.0
2104,5,2350,973.0,1377,234.0,973,2.0,1920,393.0
2105,5,1540,572.0,884,0.0,656,0.0,1905,0.0
2106,2,1086,723.0,723,0.0,363,2.0,1920,400.0
2107,7,2495,1313.0,1313,0.0,1182,2.0,1890,342.0
2108,5,984,984.0,984,200.0,0,1.0,1959,308.0
2109,4,1093,869.0,1093,0.0,0,1.0,1958,308.0
2110,5,1143,1008.0,1143,406.0,0,1.0,1928,288.0
2111,7,1668,672.0,1195,0.0,473,1.0,1945,252.0
2112,5,1738,1024.0,1144,175.0,594,1.0,1935,240.0
2113,5,1210,672.0,832,600.0,378,1.0,1941,240.0
2114,6,1290,554.0,736,0.0,554,1.0,1900,200.0
2115,6,1672,981.0,1014,521.0,658,1.0,1940,240.0
2116,5,949,949.0,949,0.0,0,2.0,1924,370.0
2117,6,1497,825.0,825,201.0,672,1.0,1937,672.0
2118,6,1342,739.0,874,264.0,468,1.0,1939,240.0
2119,6,1013,992.0,1013,0.0,0,1.0,1926,160.0
2120,5,1216,565.0,565,68.0,651,1.0,1920,355.0
2121,4,896,0.0,896,0.0,0,1.0,1946,280.0
2122,4,1136,704.0,624,80.0,512,1.0,1929,336.0
2123,5,808,0.0,808,0.0,0,1.0,1945,164.0
2124,7,2009,989.0,1245,300.0,764,2.0,1939,400.0
2125,5,1902,1100.0,1226,203.0,676,2.0,1923,576.0
2126,6,1716,810.0,1170,0.0,546,2.0,1915,672.0
2127,6,1984,1242.0,1242,196.0,742,1.0,1910,360.0
2128,6,1609,796.0,825,0.0,784,1.0,1910,228.0
2129,6,768,768.0,768,0.0,0,2.0,1930,440.0
2130,6,1536,768.0,768,372.0,768,1.0,1952,308.0
2131,6,1969,1272.0,1272,0.0,0,2.0,1938,400.0
2132,5,1308,880.0,880,0.0,428,2.0,1915,400.0
2133,6,1040,1040.0,1040,0.0,0,2.0,1925,320.0
2134,6,1236,768.0,788,121.0,448,1.0,1925,384.0
2135,5,759,451.0,759,0.0,0,2.0,1912,576.0
2136,3,1344,536.0,808,0.0,536,0.0,1915,0.0
2137,5,1054,1046.0,1054,0.0,0,1.0,1947,240.0
2138,5,1075,981.0,1075,784.0,0,2.0,1963,440.0
2139,6,1096,1008.0,1096,528.0,0,2.0,1978,484.0
2140,5,992,992.0,992,758.0,0,1.0,1967,294.0
2141,6,1034,450.0,1034,450.0,0,2.0,1978,504.0
2142,5,1073,1073.0,1073,221.0,0,1.0,1967,270.0
2143,5,1126,1060.0,1126,104.0,0,2.0,1984,506.0
2144,5,1140,1300.0,1140,1300.0,0,2.0,1920,400.0
2145,5,960,960.0,960,634.0,0,1.0,1963,300.0
2146,6,1188,988.0,1188,776.0,0,2.0,1956,621.0
2147,5,1721,988.0,1721,988.0,0,2.0,1960,626.0
2148,5,1350,576.0,864,336.0,486,3.0,1941,627.0
2149,5,904,864.0,904,704.0,0,3.0,1970,912.0
2150,7,1524,1524.0,1524,599.0,0,2.0,1979,478.0
2151,7,1079,570.0,617,0.0,462,1.0,1948,249.0
2152,5,1518,1580.0,1518,1035.0,0,0.0,1940,0.0
2153,5,1509,1509.0,1509,870.0,0,1.0,1956,322.0
2154,5,864,864.0,864,864.0,0,0.0,1975,0.0
2155,6,1269,621.0,621,324.0,648,1.0,1962,280.0
2156,6,2814,1077.0,1093,779.0,1721,2.0,1995,614.0
2157,7,1626,1602.0,1626,1271.0,0,2.0,1994,534.0
2158,7,2200,812.0,1101,355.0,1099,2.0,1993,453.0
2159,7,2037,672.0,1302,0.0,735,2.0,1996,472.0
2160,7,1356,628.0,628,0.0,728,2.0,2007,484.0
2161,8,1615,1615.0,1615,0.0,0,3.0,2007,864.0
2162,9,2276,2271.0,2276,2085.0,0,3.0,2008,1348.0
2163,9,1766,1751.0,1766,1153.0,0,3.0,2008,874.0
2164,8,1511,1401.0,1511,770.0,0,3.0,1995,811.0
2165,6,1643,1182.0,1643,262.0,0,2.0,1966,438.0
2166,5,990,990.0,990,722.0,0,2.0,1994,528.0
2167,7,1418,1418.0,1418,1308.0,0,2.0,1997,558.0
2168,6,1771,864.0,872,688.0,899,2.0,1997,600.0
2169,7,1652,782.0,782,527.0,870,2.0,2000,532.0
2170,7,1823,928.0,928,663.0,895,2.0,2000,626.0
2171,5,1174,864.0,1174,781.0,0,2.0,1978,528.0
2172,5,1076,1076.0,1076,294.0,0,2.0,1975,576.0
2173,5,1558,864.0,1558,88.0,0,2.0,1975,440.0
2174,7,2161,1257.0,1290,0.0,871,2.0,2001,570.0
2175,9,1947,1357.0,1366,1194.0,581,3.0,2001,725.0
2176,8,1786,1778.0,1786,1538.0,0,3.0,2002,715.0
2177,7,2327,1129.0,1129,0.0,1198,2.0,2003,596.0
2178,8,1764,850.0,886,0.0,878,2.0,1999,560.0
2179,6,848,848.0,848,662.0,0,2.0,2004,420.0
2180,6,1838,1838.0,1838,1593.0,0,3.0,1997,721.0
2181,7,1445,1445.0,1445,24.0,0,2.0,2004,470.0
2182,7,1564,1564.0,1564,56.0,0,3.0,2007,814.0
2183,7,1361,1351.0,1361,24.0,0,2.0,2007,610.0
2184,5,1092,1092.0,1092,609.0,0,1.0,1966,264.0
2185,5,1033,456.0,1033,456.0,0,2.0,1976,504.0
2186,6,1127,1127.0,1127,1033.0,0,2.0,1976,480.0
2187,6,1117,1029.0,1117,368.0,0,2.0,1977,542.0
2188,6,1398,684.0,684,288.0,714,2.0,1976,440.0
2189,5,3820,0.0,3820,0.0,0,2.0,1959,624.0
2190,4,1152,0.0,1152,0.0,0,0.0,1955,0.0
2191,4,1152,0.0,1152,0.0,0,0.0,1955,0.0
2192,4,784,784.0,784,784.0,0,0.0,1955,0.0
2193,5,1053,585.0,585,0.0,468,0.0,1938,0.0
2194,5,1137,0.0,929,0.0,208,0.0,1947,0.0
2195,4,930,911.0,930,767.0,0,1.0,1953,286.0
2196,4,1204,416.0,1204,0.0,0,1.0,1954,312.0
2197,4,1292,949.0,949,224.0,343,1.0,1923,205.0
2198,7,1424,1228.0,1424,0.0,0,1.0,1921,312.0
2199,6,1920,960.0,960,281.0,960,2.0,1930,480.0
2200,6,1316,644.0,672,379.0,644,1.0,1926,369.0
2201,6,1264,676.0,676,0.0,588,2.0,1914,400.0
2202,8,1512,798.0,798,406.0,714,1.0,1925,180.0
2203,6,1603,784.0,819,0.0,784,2.0,1923,599.0
2204,5,1938,942.0,1265,606.0,673,1.0,1937,240.0
2205,5,1374,884.0,932,0.0,442,1.0,1938,225.0
2206,6,1091,1091.0,1091,500.0,0,1.0,1951,344.0
2207,8,1873,608.0,983,210.0,890,2.0,1935,786.0
2208,7,2161,832.0,1218,435.0,943,2.0,1950,506.0
2209,5,1898,1898.0,1898,1116.0,0,2.0,1956,484.0
2210,6,1032,516.0,516,366.0,516,2.0,1980,462.0
2211,6,919,894.0,919,299.0,0,1.0,1926,195.0
2212,6,1090,720.0,760,0.0,330,1.0,1940,240.0
2213,5,1200,780.0,780,0.0,420,0.0,1930,0.0
2214,5,1656,624.0,1092,257.0,564,1.0,1967,288.0
2215,5,912,520.0,912,0.0,0,1.0,1930,360.0
2216,5,1955,1151.0,1151,330.0,804,1.0,1958,356.0
2217,1,733,0.0,733,0.0,0,2.0,1952,487.0
2218,4,1361,173.0,825,0.0,536,1.0,1895,185.0
2219,4,1049,356.0,671,0.0,378,1.0,1910,195.0
2220,4,864,592.0,432,0.0,432,1.0,1920,216.0
2221,8,1648,1596.0,1648,1476.0,0,2.0,2007,525.0
2222,7,1646,1594.0,1646,1474.0,0,2.0,2004,482.0
2223,7,2032,1840.0,2032,700.0,0,3.0,1996,786.0
2224,7,1820,910.0,910,0.0,910,3.0,1996,816.0
2225,5,1872,0.0,936,0.0,936,2.0,1976,484.0
2226,4,1689,1680.0,1689,1383.0,0,2.0,1991,432.0
2227,7,1501,1277.0,1501,893.0,0,2.0,1986,512.0
2228,8,1537,1518.0,1537,1036.0,0,3.0,2006,788.0
2229,8,1780,920.0,920,770.0,860,2.0,2007,612.0
2230,5,1442,352.0,712,0.0,730,2.0,2006,400.0
2231,7,1612,796.0,796,0.0,816,3.0,2008,666.0
2232,6,1495,1495.0,1495,0.0,0,2.0,1989,438.0
2233,6,1256,1256.0,1256,920.0,0,2.0,1986,578.0
2234,8,1440,1432.0,1440,1029.0,0,2.0,2003,467.0
2235,6,1675,1666.0,1675,1223.0,0,2.0,1999,435.0
2236,8,1728,1884.0,1728,1011.0,0,2.0,2007,520.0
2237,8,1964,1964.0,1964,1571.0,0,3.0,2005,892.0
2238,7,1344,1344.0,1344,1309.0,0,4.0,1997,784.0
2239,5,1092,1092.0,1092,0.0,0,0.0,2007,0.0
2240,6,1189,1189.0,1189,864.0,0,2.0,1997,392.0
2241,4,1200,1200.0,1200,865.0,0,3.0,1964,850.0
2242,5,1040,1040.0,1040,769.0,0,2.0,1975,499.0
2243,5,1475,550.0,925,318.0,550,1.0,1976,336.0
2244,4,988,526.0,526,501.0,462,1.0,1973,297.0
2245,4,988,462.0,526,437.0,462,1.0,1973,297.0
2246,5,1160,1113.0,1160,785.0,0,1.0,1968,257.0
2247,6,1092,546.0,546,358.0,546,0.0,1970,0.0
2248,5,816,816.0,816,534.0,0,1.0,1983,264.0
2249,5,845,845.0,845,638.0,0,1.0,1982,264.0
2250,5,889,864.0,889,647.0,0,2.0,1984,484.0
2251,5,1836,686.0,1150,0.0,686,1.0,1900,288.0
2252,6,1587,1587.0,1587,838.0,0,2.0,1971,525.0
2253,6,1384,384.0,754,0.0,630,2.0,1997,390.0
2254,6,1694,392.0,924,186.0,770,2.0,1994,398.0
2255,6,1714,923.0,947,871.0,767,2.0,1999,451.0
2256,7,1553,691.0,691,414.0,862,2.0,1996,420.0
2257,6,2299,938.0,957,0.0,1342,2.0,1999,482.0
2258,7,1187,1168.0,1187,0.0,0,2.0,1992,420.0
2259,6,1642,903.0,910,0.0,732,2.0,1993,392.0
2260,6,1128,1302.0,1128,550.0,0,2.0,1964,480.0
2261,8,1179,1166.0,1179,248.0,0,2.0,1988,480.0
2262,8,1321,1312.0,1321,926.0,0,2.0,1990,484.0
2263,8,2541,1149.0,1164,986.0,1377,3.0,2005,729.0
2264,9,2338,2660.0,2338,1101.0,0,3.0,2006,1110.0
2265,5,1424,1100.0,1424,1047.0,0,3.0,1969,828.0
2266,9,1612,1612.0,1612,797.0,0,2.0,2006,556.0
2267,8,2234,2220.0,2234,1558.0,0,2.0,2006,724.0
2268,10,2042,1742.0,2042,1152.0,0,3.0,2006,724.0
2269,6,1284,1284.0,1284,256.0,0,2.0,1984,480.0
2270,7,1479,725.0,725,321.0,754,2.0,1981,484.0
2271,7,1664,1529.0,1664,1328.0,0,2.0,1978,663.0
2272,7,1930,780.0,1085,758.0,845,2.0,1979,481.0
2273,6,1177,1153.0,1177,781.0,0,2.0,1984,495.0
2274,6,1353,1259.0,1353,903.0,0,2.0,1979,478.0
2275,6,1220,1625.0,1220,492.0,0,2.0,1971,944.0
2276,7,1324,1228.0,1324,624.0,0,2.0,1976,585.0
2277,6,1877,1084.0,1084,931.0,793,2.0,1974,488.0
2278,5,1422,925.0,1422,566.0,0,2.0,1970,576.0
2279,5,914,914.0,914,81.0,0,1.0,1970,368.0
2280,4,914,914.0,914,314.0,0,1.0,1961,270.0
2281,6,1337,1337.0,1337,0.0,0,2.0,2001,511.0
2282,6,1337,1405.0,1337,930.0,0,2.0,1997,522.0
2283,6,1092,525.0,525,312.0,567,1.0,1973,264.0
2284,6,1218,672.0,672,0.0,546,1.0,1973,264.0
2285,7,1055,1061.0,1055,632.0,0,1.0,1978,319.0
2286,5,988,988.0,988,725.0,0,1.0,1966,360.0
2287,9,1816,1790.0,1816,1151.0,0,3.0,2006,730.0
2288,8,1694,1694.0,1694,0.0,0,3.0,2006,856.0
2289,8,2122,2108.0,2122,1518.0,0,3.0,2007,938.0
2290,9,2656,1934.0,1943,1304.0,713,3.0,2007,1040.0
2291,8,2550,1108.0,1148,0.0,1402,3.0,2006,670.0
2292,10,2046,1994.0,2046,1430.0,0,3.0,2005,878.0
2293,9,2552,2552.0,2552,1812.0,0,3.0,2007,932.0
2294,9,2758,1704.0,1722,0.0,1036,3.0,2005,814.0
2295,10,2290,2320.0,2290,1684.0,0,3.0,2007,1174.0
2296,8,2152,1582.0,1582,0.0,570,2.0,2007,728.0
2297,8,2100,918.0,958,778.0,1142,3.0,2007,786.0
2298,9,1802,1802.0,1802,0.0,0,3.0,2006,843.0
2299,8,2956,1706.0,1718,0.0,1238,3.0,2004,916.0
2300,8,2385,1317.0,1217,938.0,1168,3.0,2003,818.0
2301,8,1818,895.0,895,669.0,923,3.0,2007,774.0
2302,7,1614,1614.0,1614,1178.0,0,3.0,2005,878.0
2303,8,1721,1721.0,1721,119.0,0,2.0,2005,554.0
2304,8,1828,1298.0,1298,0.0,530,3.0,2006,876.0
2305,6,1302,1302.0,1302,866.0,0,2.0,2005,631.0
2306,6,1302,1302.0,1302,1030.0,0,2.0,2005,631.0
2307,6,1362,1362.0,1362,762.0,0,2.0,2005,460.0
2308,8,1554,1554.0,1554,24.0,0,2.0,2006,627.0
2309,9,1577,1577.0,1577,848.0,0,2.0,2005,564.0
2310,8,1324,1324.0,1324,24.0,0,2.0,2006,550.0
2311,7,1405,1405.0,1405,1000.0,0,2.0,2003,478.0
2312,6,1496,768.0,768,0.0,728,2.0,2007,572.0
2313,6,1536,768.0,768,0.0,768,2.0,2005,400.0
2314,7,1458,608.0,608,0.0,850,2.0,2006,454.0
2315,6,1495,738.0,738,0.0,757,2.0,2006,440.0
2316,6,1746,698.0,698,0.0,1048,3.0,2006,350.0
2317,6,1326,1326.0,1326,918.0,0,2.0,2005,388.0
2318,6,1504,752.0,752,0.0,752,2.0,2007,440.0
2319,7,1456,728.0,728,0.0,728,2.0,2007,400.0
2320,7,1258,1246.0,1258,0.0,0,2.0,2007,462.0
2321,8,1589,1406.0,1589,1084.0,0,3.0,2003,630.0
2322,7,1266,1266.0,1266,0.0,0,2.0,2007,388.0
2323,7,1119,835.0,1119,779.0,0,2.0,2004,437.0
2324,7,1374,384.0,744,192.0,630,2.0,2004,400.0
2325,7,1525,1510.0,1525,0.0,0,2.0,2006,534.0
2326,7,1394,384.0,754,0.0,640,2.0,2003,400.0
2327,7,1948,847.0,847,0.0,1101,2.0,2003,434.0
2328,7,1995,854.0,864,574.0,1131,2.0,2002,435.0
2329,6,1690,915.0,940,520.0,750,2.0,2000,442.0
2330,6,1644,941.0,961,0.0,683,2.0,1999,460.0
2331,8,2551,1779.0,1779,1181.0,772,3.0,1997,925.0
2332,9,3078,1408.0,1671,672.0,1407,3.0,1998,806.0
2333,8,2582,1389.0,1411,1048.0,1171,3.0,1998,758.0
2334,7,2385,1066.0,1108,0.0,1277,3.0,1998,600.0
2335,8,2202,1105.0,1105,335.0,1097,2.0,1992,517.0
2336,8,2538,1325.0,1335,1225.0,1203,3.0,1996,933.0
2337,7,1369,1369.0,1369,0.0,0,2.0,2007,605.0
2338,8,1542,1542.0,1542,1220.0,0,3.0,2007,852.0
2339,8,1534,1524.0,1534,28.0,0,2.0,2006,484.0
2340,10,1966,1966.0,1966,1572.0,0,3.0,2007,1092.0
2341,7,1528,1528.0,1528,0.0,0,2.0,2007,480.0
2342,8,1538,1538.0,1538,769.0,0,2.0,2005,484.0
2343,7,1506,1494.0,1506,778.0,0,2.0,2005,672.0
2344,7,1977,982.0,982,0.0,995,3.0,2006,574.0
2345,8,1830,1302.0,1302,0.0,528,3.0,2006,859.0
2346,8,1338,1338.0,1338,24.0,0,2.0,2007,598.0
2347,7,1335,1335.0,1335,0.0,0,2.0,2006,575.0
2348,8,1792,896.0,896,350.0,896,2.0,2007,590.0
2349,5,1588,725.0,725,0.0,863,2.0,2007,561.0
2350,8,1880,955.0,955,745.0,925,3.0,2007,880.0
2351,8,1584,1574.0,1584,0.0,0,2.0,2007,594.0
2352,8,1685,1685.0,1685,0.0,0,3.0,2006,658.0
2353,6,2443,1158.0,1158,0.0,1285,3.0,2004,744.0
2354,6,1100,1100.0,1100,0.0,0,0.0,2006,0.0
2355,7,1143,1143.0,1143,0.0,0,0.0,2006,0.0
2356,5,1094,1094.0,1094,729.0,0,2.0,2003,576.0
2357,7,1486,1461.0,1486,0.0,0,2.0,2006,566.0
2358,6,1820,864.0,920,480.0,900,2.0,1993,492.0
2359,6,1266,630.0,630,0.0,636,1.0,1980,283.0
2360,5,894,894.0,894,138.0,0,1.0,1977,308.0
2361,5,1040,1040.0,1040,812.0,0,2.0,1968,686.0
2362,7,2503,1223.0,1271,727.0,1232,2.0,1990,564.0
2363,5,1037,1037.0,1037,787.0,0,2.0,1974,431.0
2364,6,1055,1044.0,1055,968.0,0,2.0,1973,542.0
2365,8,1378,1378.0,1378,851.0,0,2.0,2004,540.0
2366,8,1151,1141.0,1151,60.0,0,2.0,2006,484.0
2367,8,1565,1511.0,1565,60.0,0,2.0,2006,476.0
2368,7,1352,1352.0,1352,937.0,0,2.0,2006,466.0
2369,8,1550,1550.0,1550,0.0,0,2.0,2006,528.0
2370,6,1501,744.0,757,565.0,744,2.0,1999,440.0
2371,6,1573,756.0,769,417.0,804,2.0,2000,440.0
2372,7,1358,1339.0,1358,0.0,0,2.0,1999,625.0
2373,8,2048,1054.0,1072,964.0,976,2.0,2003,552.0
2374,8,2362,1220.0,1220,901.0,1142,2.0,1998,1105.0
2375,8,1494,1494.0,1494,457.0,0,2.0,1994,478.0
2376,7,2362,2002.0,2362,1732.0,0,2.0,1980,546.0
2377,8,2497,2461.0,2497,1632.0,0,2.0,1981,676.0
2378,6,1152,912.0,1152,0.0,0,2.0,1968,412.0
2379,6,2411,1008.0,1403,915.0,1008,2.0,1970,570.0
2380,6,1082,973.0,1082,973.0,0,2.0,1969,480.0
2381,6,1295,1295.0,1295,910.0,0,2.0,1968,528.0
2382,7,1610,1124.0,1610,346.0,0,2.0,1972,515.0
2383,7,1594,1594.0,1594,0.0,0,2.0,1993,472.0
2384,7,2075,1148.0,1091,819.0,984,2.0,1993,473.0
2385,6,1093,1093.0,1093,792.0,0,2.0,1966,484.0
2386,6,1052,1052.0,1052,617.0,0,1.0,1963,311.0
2387,5,1107,949.0,1107,474.0,0,1.0,1967,308.0
2388,4,1224,0.0,1224,0.0,0,3.0,1964,530.0
2389,5,1074,894.0,1074,438.0,0,2.0,1956,396.0
2390,5,1187,864.0,1187,311.0,0,2.0,1961,440.0
2391,5,964,964.0,964,700.0,0,2.0,1961,784.0
2392,5,894,894.0,894,0.0,0,1.0,1960,312.0
2393,7,1200,1174.0,1200,654.0,0,2.0,1966,440.0
2394,6,1042,1042.0,1042,494.0,0,2.0,1965,440.0
2395,6,2154,845.0,845,414.0,1309,2.0,1964,539.0
2396,6,1374,1130.0,1374,54.0,0,1.0,1964,286.0
2397,6,1652,1592.0,1652,1386.0,0,2.0,1959,510.0
2398,5,908,822.0,908,130.0,0,2.0,1940,512.0
2399,3,666,666.0,666,299.0,0,0.0,1946,0.0
2400,3,670,370.0,442,144.0,228,0.0,1945,0.0
2401,5,808,808.0,808,150.0,0,1.0,1958,308.0
2402,5,1150,1078.0,1150,368.0,0,1.0,1955,288.0
2403,5,1560,1560.0,1560,0.0,0,3.0,1968,792.0
2404,5,1280,793.0,1280,602.0,0,2.0,1966,432.0
2405,6,1254,1218.0,1254,600.0,0,2.0,1961,525.0
2406,6,936,936.0,936,873.0,0,1.0,1957,315.0
2407,5,1008,1008.0,1008,908.0,0,1.0,1956,308.0
2408,5,1053,1053.0,1053,288.0,0,2.0,1963,692.0
2409,5,1144,1144.0,1144,0.0,0,1.0,1960,336.0
2410,6,1721,1331.0,1721,668.0,0,2.0,1957,464.0
2411,5,922,922.0,922,512.0,0,1.0,1957,308.0
2412,5,1411,1204.0,1411,780.0,0,1.0,1955,310.0
2413,5,1216,1216.0,1216,288.0,0,1.0,1955,336.0
2414,5,1154,864.0,1154,408.0,0,1.0,1953,336.0
2415,5,1560,1560.0,1560,0.0,0,2.0,1958,484.0
2416,6,948,948.0,948,441.0,0,2.0,1952,410.0
2417,6,1040,1040.0,1040,85.0,0,1.0,1953,293.0
2418,5,925,925.0,925,114.0,0,1.0,1956,252.0
2419,4,1540,1190.0,1040,150.0,500,1.0,1955,352.0
2420,5,925,923.0,925,793.0,0,1.0,1955,390.0
2421,4,1647,1105.0,1647,595.0,0,1.0,1953,280.0
2422,5,924,924.0,924,292.0,0,1.0,1952,420.0
2423,4,1544,925.0,1000,0.0,544,0.0,1890,0.0
2424,5,1728,1216.0,1216,198.0,0,1.0,1953,371.0
2425,5,3086,666.0,1308,0.0,1778,3.0,1935,1200.0
2426,4,1281,1151.0,845,1030.0,436,2.0,1925,580.0
2427,5,1534,736.0,751,0.0,783,0.0,1895,0.0
2428,7,1651,725.0,1035,242.0,616,1.0,1963,276.0
2429,5,888,920.0,888,192.0,0,1.0,1961,240.0
2430,6,952,952.0,952,952.0,0,1.0,1968,288.0
2431,5,1238,864.0,1238,432.0,0,1.0,1950,357.0
2432,5,1040,1040.0,1040,574.0,0,1.0,1959,286.0
2433,5,1170,1170.0,1170,625.0,0,1.0,1958,338.0
2434,5,1242,1242.0,1242,739.0,0,1.0,1960,324.0
2435,5,1377,1377.0,1377,1098.0,0,1.0,1960,351.0
2436,5,925,0.0,925,0.0,0,1.0,1961,300.0
2437,5,864,864.0,864,110.0,0,1.0,1962,294.0
2438,5,936,896.0,936,734.0,0,1.0,1962,288.0
2439,5,960,850.0,960,0.0,0,2.0,1926,576.0
2440,6,1296,845.0,866,276.0,430,2.0,1927,576.0
2441,5,1022,1022.0,1022,782.0,0,1.0,1922,184.0
2442,5,967,967.0,967,0.0,0,1.0,1920,180.0
2443,5,1072,808.0,1072,0.0,0,2.0,1940,379.0
2444,5,1174,680.0,680,130.0,494,2.0,1900,576.0
2445,4,1141,570.0,761,122.0,380,1.0,1900,252.0
2446,4,1798,1075.0,1156,0.0,642,2.0,1900,342.0
2447,8,1772,725.0,909,0.0,863,2.0,1910,816.0
2448,6,1642,728.0,914,196.0,728,1.0,1927,374.0
2449,5,1232,616.0,616,168.0,616,2.0,1910,480.0
2450,6,1650,926.0,991,259.0,659,2.0,1910,468.0
2451,5,1358,687.0,687,316.0,671,1.0,1930,336.0
2452,7,2454,819.0,1312,0.0,1142,2.0,1879,576.0
2453,4,968,0.0,968,0.0,0,1.0,1956,331.0
2454,4,1382,0.0,1382,0.0,0,1.0,1949,384.0
2455,5,1060,756.0,916,317.0,144,1.0,1925,308.0
2456,5,1435,910.0,910,910.0,525,1.0,1950,308.0
2457,5,1274,728.0,728,306.0,546,1.0,1939,224.0
2458,6,1232,600.0,608,276.0,624,1.0,1939,217.0
2459,5,884,884.0,884,0.0,0,1.0,1939,240.0
2460,6,1409,861.0,861,52.0,548,2.0,1938,528.0
2461,5,1322,672.0,899,48.0,423,1.0,1939,280.0
2462,5,1426,966.0,1014,0.0,412,1.0,1930,230.0
2463,5,1281,756.0,903,351.0,378,2.0,1926,379.0
2464,6,2264,1100.0,1100,0.0,1164,1.0,1918,408.0
2465,6,1376,768.0,752,0.0,624,2.0,1920,576.0
2466,5,1316,750.0,960,0.0,356,2.0,1926,576.0
2467,7,1344,672.0,672,336.0,672,2.0,1929,456.0
2468,5,1173,592.0,933,0.0,240,1.0,1901,240.0
2469,5,1214,969.0,969,0.0,245,1.0,1901,216.0
2470,6,2294,741.0,1497,375.0,797,2.0,1963,658.0
2471,7,1952,976.0,976,354.0,976,1.0,1950,299.0
2472,6,2180,1138.0,1138,375.0,1042,2.0,1915,720.0
2473,4,1315,808.0,838,681.0,477,2.0,1958,436.0
2474,4,1484,771.0,866,0.0,504,1.0,1910,264.0
2475,7,2267,1005.0,1262,288.0,1005,2.0,1937,498.0
2476,5,1282,672.0,778,485.0,504,1.0,1942,240.0
2477,5,999,925.0,999,925.0,0,1.0,1963,308.0
2478,5,1452,1420.0,1452,785.0,0,2.0,1964,572.0
2479,4,1005,1005.0,1005,513.0,0,2.0,1964,440.0
2480,5,1020,980.0,1020,68.0,0,2.0,1964,528.0
2481,5,1040,1040.0,1040,249.0,0,1.0,1966,264.0
2482,5,868,768.0,868,748.0,0,2.0,1971,576.0
2483,5,897,876.0,897,168.0,0,1.0,1968,264.0
2484,5,943,943.0,943,114.0,0,2.0,1967,528.0
2485,5,912,912.0,912,216.0,0,1.0,1966,315.0
2486,5,1375,1240.0,1375,386.0,0,1.0,1956,323.0
2487,5,2654,671.0,1567,267.0,1087,2.0,1920,638.0
2488,7,1302,680.0,798,258.0,504,1.0,1940,224.0
2489,6,1299,967.0,1299,736.0,0,2.0,1954,494.0
2490,5,1176,1158.0,1176,190.0,0,1.0,1958,303.0
2491,4,998,0.0,998,0.0,0,2.0,1945,460.0
2492,6,1522,1190.0,1522,299.0,0,2.0,1984,552.0
2493,5,1325,409.0,1325,300.0,0,2.0,1948,576.0
2494,5,1630,1073.0,1630,587.0,0,2.0,1953,649.0
2495,4,1242,484.0,1242,0.0,0,1.0,1946,336.0
2496,6,2422,1288.0,2422,353.0,0,2.0,1954,527.0
2497,6,1626,988.0,988,491.0,638,1.0,1954,332.0
2498,5,864,864.0,864,453.0,0,1.0,1958,399.0
2499,4,943,0.0,943,0.0,0,1.0,1958,308.0
2500,5,1038,1038.0,1038,283.0,0,1.0,1984,264.0
2501,5,1342,1342.0,1342,557.0,0,1.0,1951,256.0
2502,5,1480,1080.0,1080,1080.0,400,1.0,1951,253.0
2503,4,1362,951.0,986,0.0,376,1.0,1920,280.0
2504,6,1822,1105.0,1105,0.0,717,2.0,1984,515.0
2505,7,1958,779.0,1029,497.0,929,2.0,1994,499.0
2506,8,1651,1643.0,1651,0.0,0,3.0,2007,870.0
2507,8,2140,2140.0,2140,0.0,0,3.0,2006,894.0
2508,8,1651,1643.0,1651,0.0,0,3.0,2007,870.0
2509,7,1546,1546.0,1546,20.0,0,3.0,2005,796.0
2510,8,1500,1489.0,1500,36.0,0,2.0,2006,674.0
2511,7,1270,1270.0,1270,0.0,0,2.0,2005,524.0
2512,7,1795,879.0,879,0.0,916,2.0,2005,578.0
2513,7,1873,929.0,946,608.0,927,2.0,1988,619.0
2514,8,1743,966.0,1743,51.0,0,2.0,1976,529.0
2515,5,1022,1022.0,1022,550.0,0,2.0,1994,747.0
2516,6,1308,635.0,646,539.0,662,2.0,1997,497.0
2517,5,990,990.0,990,420.0,0,1.0,1994,384.0
2518,5,1097,1097.0,1097,549.0,0,1.0,1996,242.0
2519,7,1873,988.0,988,342.0,885,2.0,1999,597.0
2520,7,1753,853.0,853,638.0,900,2.0,1998,534.0
2521,7,1690,845.0,845,0.0,845,2.0,2001,517.0
2522,7,1842,985.0,985,841.0,857,2.0,2000,486.0
2523,5,894,864.0,894,663.0,0,2.0,1974,440.0
2524,5,1025,1015.0,1025,502.0,0,2.0,1976,370.0
2525,5,1009,995.0,1009,755.0,0,2.0,1977,576.0
2526,5,1040,1040.0,1040,539.0,0,2.0,1977,748.0
2527,5,907,876.0,907,60.0,0,1.0,1977,308.0
2528,5,879,864.0,879,330.0,0,2.0,1975,440.0
2529,5,864,864.0,864,671.0,0,2.0,1972,576.0
2530,4,875,385.0,875,385.0,0,2.0,1972,728.0
2531,7,1673,1673.0,1673,1412.0,0,2.0,2000,583.0
2532,7,1932,979.0,992,654.0,940,2.0,2003,610.0
2533,7,1729,860.0,860,0.0,869,2.0,2002,542.0
2534,8,1592,1556.0,1592,408.0,0,2.0,1994,484.0
2535,8,2439,1531.0,1531,1198.0,908,2.0,2001,560.0
2536,7,1992,860.0,1212,762.0,780,2.0,1996,608.0
2537,8,1341,1341.0,1341,915.0,0,2.0,1999,482.0
2538,7,1476,738.0,738,0.0,738,2.0,2007,552.0
2539,7,1190,1169.0,1190,709.0,0,2.0,2005,578.0
2540,6,1330,1330.0,1330,0.0,0,2.0,2006,437.0
2541,7,1491,738.0,738,0.0,753,2.0,2006,484.0
2542,5,1536,768.0,768,0.0,768,2.0,2005,400.0
2543,5,936,936.0,936,936.0,0,1.0,1967,384.0
2544,4,1088,1088.0,1088,132.0,0,2.0,1963,520.0
2545,5,1351,901.0,901,130.0,450,2.0,1925,576.0
2546,6,1179,1179.0,1179,0.0,0,2.0,1960,622.0
2547,6,1044,960.0,1044,504.0,0,2.0,1976,528.0
2548,5,2233,0.0,1100,0.0,1133,2.0,1979,579.0
2549,5,1408,734.0,734,611.0,674,2.0,2005,489.0
2550,10,5095,5095.0,5095,4010.0,0,3.0,2008,1154.0
2551,6,1072,547.0,1072,467.0,0,2.0,2005,525.0
2552,5,960,960.0,960,77.0,0,1.0,1959,392.0
2553,4,1152,0.0,1152,0.0,0,0.0,1955,0.0
2554,5,1195,1195.0,1195,0.0,0,0.0,1946,0.0
2555,6,865,660.0,740,144.0,125,1.0,1920,216.0
2556,4,768,768.0,768,544.0,0,1.0,1955,355.0
2557,4,864,864.0,864,682.0,0,2.0,1955,528.0
2558,5,2592,1296.0,1296,371.0,1296,0.0,1923,0.0
2559,5,1422,1290.0,1422,319.0,0,1.0,1926,352.0
2560,6,1298,651.0,759,113.0,539,1.0,1921,240.0
2561,7,1098,531.0,567,246.0,531,1.0,1930,216.0
2562,6,1436,585.0,851,0.0,585,1.0,1921,228.0
2563,6,1461,686.0,686,0.0,775,1.0,1926,225.0
2564,7,1718,851.0,867,0.0,851,2.0,1927,264.0
2565,5,1226,0.0,1226,0.0,0,2.0,1951,400.0
2566,4,1755,930.0,1230,189.0,525,1.0,1930,231.0
2567,5,1355,728.0,760,533.0,595,2.0,1941,528.0
2568,6,1560,1560.0,1560,540.0,0,2.0,1960,580.0
2569,6,1488,1488.0,1488,813.0,0,2.0,1968,552.0
2570,6,1045,516.0,529,330.0,516,2.0,1980,462.0
2571,4,1680,1680.0,1680,0.0,0,2.0,1995,628.0
2572,8,1020,1004.0,1020,577.0,0,2.0,1988,509.0
2573,7,1696,1696.0,1696,434.0,0,2.0,1971,625.0
2574,8,2726,279.0,2726,0.0,0,2.0,1986,691.0
2575,6,1215,720.0,720,375.0,495,2.0,1940,720.0
2576,5,1601,936.0,936,0.0,665,0.0,1925,0.0
2577,5,1828,859.0,942,548.0,886,0.0,1923,0.0
2578,5,816,816.0,816,0.0,0,1.0,1922,100.0
2579,2,845,0.0,640,0.0,0,1.0,1939,256.0
2580,5,1991,957.0,1034,0.0,957,0.0,1895,0.0
2581,4,1073,1073.0,1073,967.0,0,2.0,1957,720.0
2582,5,1001,837.0,1001,737.0,0,1.0,1930,216.0
2583,8,1625,1573.0,1625,1573.0,0,2.0,2006,495.0
2584,6,1299,1001.0,1299,1001.0,0,2.0,1979,486.0
2585,5,1392,1441.0,1392,585.0,0,3.0,2002,650.0
2586,7,1409,1409.0,1409,1392.0,0,2.0,2002,576.0
2587,7,1478,1454.0,1478,1239.0,0,2.0,1991,506.0
2588,7,918,852.0,918,224.0,0,1.0,1975,360.0
2589,6,1026,970.0,1026,924.0,0,2.0,1974,528.0
2590,7,1501,1501.0,1501,949.0,0,2.0,1987,512.0
2591,6,2279,585.0,2279,0.0,0,2.0,1958,461.0
2592,7,1689,1689.0,1689,0.0,0,2.0,2006,433.0
2593,8,1564,1546.0,1564,583.0,0,2.0,2006,502.0
2594,7,1240,1265.0,1240,215.0,0,2.0,1985,528.0
2595,8,1312,1267.0,1312,250.0,0,2.0,2001,471.0
2596,8,1922,1922.0,1922,1329.0,0,3.0,2002,692.0
2597,6,1491,1491.0,1491,0.0,0,2.0,1996,571.0
2598,7,2486,1122.0,1146,766.0,1340,2.0,2003,452.0
2599,10,1824,1824.0,1824,0.0,0,3.0,2006,932.0
2600,3,2034,0.0,2034,0.0,0,4.0,1953,1041.0
2601,6,936,920.0,936,16.0,0,2.0,1996,460.0
2602,4,1092,546.0,546,252.0,546,1.0,1972,253.0
2603,4,992,530.0,530,503.0,462,1.0,1970,297.0
2604,4,1092,546.0,546,384.0,546,0.0,1970,0.0
2605,4,1092,546.0,546,0.0,546,1.0,1976,286.0
2606,5,1008,923.0,1008,923.0,0,2.0,1977,678.0
2607,6,1356,1244.0,1356,1148.0,0,2.0,1977,528.0
2608,5,1676,1160.0,1676,1112.0,0,2.0,1977,672.0
2609,5,1432,716.0,716,531.0,716,2.0,1977,531.0
2610,5,796,796.0,796,796.0,0,0.0,1971,0.0
2611,4,1608,1396.0,1608,811.0,0,1.0,1961,444.0
2612,5,1178,1090.0,1178,1090.0,0,2.0,1976,502.0
2613,5,816,816.0,816,596.0,0,1.0,1983,264.0
2614,5,887,864.0,887,516.0,0,1.0,1984,288.0
2615,6,1293,1178.0,1293,468.0,0,2.0,1954,452.0
2616,6,1024,1008.0,1024,773.0,0,1.0,1956,313.0
2617,5,1797,1617.0,1797,1127.0,0,3.0,1957,963.0
2618,6,1390,1705.0,1390,1110.0,0,2.0,1957,550.0
2619,7,1851,1851.0,1851,0.0,0,2.0,1969,506.0
2620,6,1525,813.0,813,700.0,712,2.0,1997,400.0
2621,6,1671,781.0,781,0.0,890,2.0,1995,423.0
2622,6,1776,821.0,821,0.0,955,2.0,1996,443.0
2623,8,2064,1074.0,1074,0.0,990,2.0,2005,527.0
2624,7,2212,1700.0,1700,60.0,512,3.0,2005,773.0
2625,8,2687,2062.0,2079,0.0,608,2.0,1994,618.0
2626,6,1169,1160.0,1169,705.0,0,2.0,1993,402.0
2627,8,1204,1191.0,1204,0.0,0,2.0,1987,461.0
2628,9,2798,1398.0,1414,1218.0,1384,3.0,2005,670.0
2629,10,3390,1528.0,1528,0.0,1862,3.0,2006,758.0
2630,9,2473,1094.0,1102,205.0,1371,3.0,2006,675.0
2631,10,2698,1850.0,1850,1206.0,848,3.0,2006,736.0
2632,9,2795,1390.0,1390,0.0,1405,3.0,2005,660.0
2633,9,1714,1714.0,1714,1191.0,0,2.0,2005,517.0
2634,9,2000,1910.0,2000,1416.0,0,3.0,2005,722.0
2635,6,1102,988.0,1102,850.0,0,2.0,1980,582.0
2636,7,1857,945.0,945,0.0,912,2.0,1978,482.0
2637,7,1083,1047.0,1083,1005.0,0,2.0,1976,596.0
2638,7,2318,960.0,960,788.0,1358,2.0,2005,541.0
2639,6,1875,675.0,1109,548.0,766,2.0,1975,485.0
2640,6,1103,1103.0,1103,755.0,0,2.0,1974,462.0
2641,4,874,864.0,874,20.0,0,2.0,1971,576.0
2642,6,1419,1487.0,1419,951.0,0,2.0,2002,543.0
2643,6,1092,525.0,525,0.0,567,2.0,1973,440.0
2644,5,1365,765.0,765,402.0,600,2.0,1973,440.0
2645,6,1030,494.0,494,282.0,536,1.0,1972,264.0
2646,6,948,483.0,483,276.0,465,1.0,1972,264.0
2647,6,1092,525.0,525,382.0,567,1.0,1972,264.0
2648,6,1069,1069.0,1069,727.0,0,2.0,1975,440.0
2649,5,1387,943.0,1387,373.0,0,1.0,1967,300.0
2650,7,1055,1055.0,1055,120.0,0,1.0,1976,319.0
2651,6,1456,855.0,855,70.0,601,2.0,1976,460.0
2652,9,2589,1738.0,1738,1369.0,851,3.0,2006,831.0
2653,8,1618,1618.0,1618,0.0,0,3.0,2004,880.0
2654,7,1740,1721.0,1740,0.0,0,3.0,2006,874.0
2655,9,1868,1868.0,1868,1505.0,0,3.0,2005,1085.0
2656,9,2206,1090.0,1117,0.0,1089,3.0,2005,670.0
2657,9,2091,1606.0,1625,1290.0,466,2.0,2005,521.0
2658,8,2253,1209.0,1209,0.0,1044,2.0,2005,575.0
2659,8,2389,1054.0,1054,0.0,1335,3.0,2006,672.0
2660,8,2358,1524.0,1544,880.0,814,3.0,2005,784.0
2661,9,1792,1792.0,1792,1232.0,0,3.0,2005,925.0
2662,9,1780,1780.0,1780,1383.0,0,3.0,2004,816.0
2663,8,1914,1420.0,1426,994.0,488,3.0,2004,746.0
2664,9,1565,1560.0,1565,472.0,0,2.0,2005,556.0
2665,9,1686,1686.0,1686,1023.0,0,3.0,2006,899.0
2666,9,1666,1666.0,1666,415.0,0,2.0,2006,575.0
2667,6,1456,728.0,728,0.0,728,2.0,2005,390.0
2668,7,1492,738.0,738,0.0,754,2.0,2006,440.0
2669,6,1326,1326.0,1326,0.0,0,2.0,2006,427.0
2670,8,2373,1052.0,1052,0.0,1321,3.0,2004,632.0
2671,7,1492,738.0,738,0.0,754,2.0,2006,440.0
2672,7,1364,1220.0,1364,453.0,0,2.0,2006,437.0
2673,7,1511,1368.0,1511,1038.0,0,2.0,2002,398.0
2674,7,1548,1365.0,1548,1059.0,0,2.0,2004,388.0
2675,7,1142,1142.0,1142,16.0,0,2.0,2005,440.0
2676,7,1598,848.0,848,0.0,750,2.0,2004,433.0
2677,6,1889,982.0,1008,732.0,881,2.0,2000,431.0
2678,7,2322,1035.0,1082,0.0,1240,3.0,2006,617.0
2679,8,1976,1044.0,1079,791.0,897,3.0,1998,885.0
2680,8,2234,1160.0,1205,505.0,1029,3.0,2000,768.0
2681,9,2855,1540.0,1540,1182.0,1315,3.0,2000,774.0
2682,8,2726,1342.0,1358,527.0,1368,3.0,1995,725.0
2683,9,3500,1733.0,1933,292.0,1567,3.0,1993,959.0
2684,8,2494,1290.0,1305,380.0,1189,3.0,1994,803.0
2685,8,2799,1286.0,1565,247.0,1234,3.0,1993,704.0
2686,8,1964,1100.0,1116,0.0,848,2.0,2005,760.0
2687,8,1670,1670.0,1670,1562.0,0,3.0,2006,928.0
2688,8,1504,1504.0,1504,0.0,0,2.0,2006,510.0
2689,8,1278,1278.0,1278,24.0,0,2.0,2006,584.0
2690,9,2640,2036.0,2036,1836.0,604,3.0,2006,792.0
2691,6,1716,858.0,858,0.0,858,2.0,2005,615.0
2692,6,1142,1142.0,1142,24.0,0,0.0,2005,0.0
2693,7,1400,1400.0,1400,0.0,0,2.0,2005,612.0
2694,6,1131,1131.0,1131,0.0,0,0.0,2005,0.0
2695,7,1686,891.0,891,0.0,795,2.0,2005,462.0
2696,7,1585,784.0,831,0.0,754,2.0,2005,449.0
2697,6,1837,941.0,941,0.0,896,2.0,1997,688.0
2698,6,1731,836.0,844,758.0,887,2.0,1992,462.0
2699,6,1398,1398.0,1398,904.0,0,2.0,1990,542.0
2700,6,1217,1217.0,1217,278.0,0,2.0,1991,484.0
2701,6,1320,636.0,636,274.0,684,2.0,1994,472.0
2702,5,988,988.0,988,36.0,0,2.0,1962,624.0
2703,6,1654,0.0,1286,0.0,368,2.0,1977,528.0
2704,5,1211,864.0,1211,612.0,0,2.0,1962,576.0
2705,5,984,984.0,984,554.0,0,1.0,1965,310.0
2706,5,909,882.0,909,162.0,0,1.0,1968,294.0
2707,5,925,925.0,925,181.0,0,2.0,1963,484.0
2708,5,1024,1024.0,1024,712.0,0,1.0,1965,308.0
2709,5,912,912.0,912,644.0,0,0.0,1964,0.0
2710,5,941,912.0,941,659.0,0,1.0,1967,288.0
2711,7,2646,1748.0,2151,1023.0,495,2.0,1974,550.0
2712,8,2826,1334.0,1520,1118.0,1306,3.0,1992,888.0
2713,7,1143,1143.0,1143,0.0,0,2.0,2004,588.0
2714,7,1223,600.0,520,0.0,623,2.0,2005,480.0
2715,6,1524,756.0,768,353.0,756,2.0,2000,440.0
2716,7,1080,530.0,530,0.0,550,2.0,2003,496.0
2717,7,1694,569.0,854,0.0,840,1.0,1997,434.0
2718,8,1568,1568.0,1568,0.0,0,2.0,2001,564.0
2719,5,1193,1153.0,1193,962.0,0,2.0,1972,501.0
2720,7,1334,1334.0,1334,553.0,0,2.0,1967,477.0
2721,5,1051,1051.0,1051,758.0,0,2.0,1968,504.0
2722,5,1770,900.0,884,361.0,886,2.0,1968,530.0
2723,6,976,976.0,976,760.0,0,2.0,1968,504.0
2724,5,898,833.0,898,744.0,0,1.0,1968,326.0
2725,5,1051,1051.0,1051,799.0,0,1.0,1966,264.0
2726,5,1141,1141.0,1141,602.0,0,1.0,1967,568.0
2727,6,1565,1187.0,1565,901.0,0,1.0,1965,299.0
2728,6,1488,1008.0,1488,260.0,0,2.0,1964,430.0
2729,5,1440,720.0,720,360.0,720,2.0,1964,480.0
2730,5,1248,1248.0,1248,632.0,0,1.0,1960,286.0
2731,6,816,816.0,816,574.0,0,1.0,1934,240.0
2732,5,1043,938.0,1043,0.0,0,1.0,1947,273.0
2733,5,1433,1251.0,1433,915.0,0,2.0,1961,441.0
2734,5,1624,1444.0,1624,40.0,0,1.0,1952,240.0
2735,5,1216,1056.0,1216,996.0,0,1.0,1951,280.0
2736,5,1728,704.0,1024,0.0,704,1.0,1949,234.0
2737,5,936,936.0,936,486.0,0,1.0,1954,240.0
2738,5,1584,1584.0,1584,0.0,0,2.0,1967,506.0
2739,6,1246,1246.0,1246,939.0,0,2.0,1964,441.0
2740,6,1008,1008.0,1008,0.0,0,2.0,1963,430.0
2741,5,1364,1179.0,1364,623.0,0,1.0,1957,331.0
2742,6,1336,1121.0,1336,203.0,0,2.0,1958,488.0
2743,5,1370,1058.0,1370,678.0,0,1.0,1956,300.0
2744,6,1124,1124.0,1124,914.0,0,1.0,1956,353.0
2745,6,1050,1050.0,1050,824.0,0,1.0,1954,286.0
2746,5,1008,1008.0,1008,658.0,0,1.0,1952,280.0
2747,6,1575,216.0,1575,0.0,0,2.0,1951,400.0
2748,5,1145,301.0,1145,271.0,0,2.0,1956,684.0
2749,5,1005,1005.0,1005,488.0,0,1.0,1956,319.0
2750,5,1056,1056.0,1056,144.0,0,1.0,1955,300.0
2751,5,884,884.0,884,741.0,0,1.0,1951,270.0
2752,7,2039,929.0,2039,0.0,0,3.0,1941,791.0
2753,5,1384,1015.0,1384,494.0,0,2.0,1956,896.0
2754,5,2640,2171.0,1392,1018.0,1248,3.0,1925,1008.0
2755,6,1312,784.0,900,0.0,412,2.0,1947,649.0
2756,3,713,713.0,713,0.0,0,1.0,1930,371.0
2757,3,715,715.0,715,0.0,0,2.0,1929,660.0
2758,4,720,448.0,448,0.0,272,1.0,1900,280.0
2759,6,1595,663.0,774,338.0,821,2.0,1915,528.0
2760,4,1760,1077.0,981,0.0,779,2.0,1910,648.0
2761,6,1146,1083.0,1146,580.0,0,1.0,1963,294.0
2762,6,1207,1135.0,1207,701.0,0,1.0,1962,264.0
2763,6,1773,1313.0,1773,913.0,0,2.0,1961,418.0
2764,7,1472,0.0,1472,0.0,0,2.0,1959,484.0
2765,7,2448,1438.0,1900,636.0,548,2.0,1962,441.0
2766,4,1521,910.0,910,455.0,611,1.0,1950,597.0
2767,3,1040,0.0,1040,0.0,0,2.0,1950,400.0
2768,5,1556,1556.0,1556,0.0,0,0.0,1960,0.0
2769,5,1150,1150.0,1150,781.0,0,1.0,1961,288.0
2770,7,1045,1045.0,1045,809.0,0,2.0,1962,528.0
2771,5,864,864.0,864,468.0,0,1.0,1962,336.0
2772,5,1025,1025.0,1025,953.0,0,0.0,1962,0.0
2773,5,2014,716.0,1007,0.0,1007,2.0,1900,624.0
2774,5,1668,1212.0,1226,276.0,442,1.0,1948,240.0
2775,4,1657,1147.0,1147,284.0,510,1.0,1920,162.0
2776,6,1416,780.0,940,381.0,476,2.0,1900,400.0
2777,7,1428,712.0,848,208.0,580,2.0,1900,576.0
2778,7,1004,502.0,502,0.0,502,1.0,1930,200.0
2779,4,1951,938.0,1084,0.0,867,2.0,1900,576.0
2780,6,1032,1032.0,1032,143.0,0,1.0,1924,280.0
2781,5,844,844.0,844,0.0,0,1.0,1925,216.0
2782,4,864,576.0,864,0.0,0,1.0,1950,528.0
2783,3,1376,738.0,714,0.0,662,1.0,1905,216.0
2784,5,960,960.0,960,576.0,0,2.0,1955,576.0
2785,5,1566,816.0,816,0.0,750,2.0,1924,450.0
2786,3,492,492.0,492,416.0,0,1.0,1921,200.0
2787,6,1182,770.0,885,310.0,297,1.0,1945,378.0
2788,3,840,798.0,840,0.0,0,1.0,1920,250.0
2789,7,2104,1226.0,1226,0.0,878,2.0,1910,432.0
2790,5,1248,624.0,624,0.0,624,0.0,1920,0.0
2791,5,960,960.0,960,0.0,0,2.0,1958,624.0
2792,3,1020,1020.0,1020,0.0,0,0.0,1918,0.0
2793,6,1827,848.0,1017,0.0,810,1.0,1924,240.0
2794,3,1162,728.0,728,347.0,434,1.0,1930,258.0
2795,5,1324,741.0,741,0.0,583,1.0,1930,180.0
2796,5,816,816.0,816,0.0,0,1.0,1925,210.0
2797,6,2486,1595.0,1611,0.0,875,2.0,1962,576.0
2798,4,1430,596.0,834,0.0,596,2.0,1924,370.0
2799,5,1330,396.0,665,0.0,665,1.0,1910,390.0
2800,5,819,610.0,819,0.0,0,0.0,1919,0.0
2801,6,984,984.0,984,343.0,0,1.0,1930,308.0
2802,5,1422,806.0,1081,329.0,341,1.0,1951,288.0
2803,6,1921,1921.0,1921,0.0,0,2.0,1964,576.0
2804,5,1640,0.0,1640,0.0,0,2.0,1950,394.0
2805,5,1032,0.0,1032,0.0,0,1.0,1935,260.0
2806,5,879,830.0,879,0.0,0,1.0,1936,180.0
2807,7,1073,1073.0,1073,510.0,0,1.0,2004,246.0
2808,5,1064,1064.0,1064,779.0,0,2.0,1967,528.0
2809,6,934,912.0,934,456.0,0,1.0,1964,336.0
2810,5,1059,1059.0,1059,773.0,0,1.0,1966,286.0
2811,5,1458,1176.0,1458,194.0,0,2.0,1967,512.0
2812,6,1040,960.0,1040,794.0,0,2.0,1978,616.0
2813,5,1967,1967.0,1967,0.0,0,2.0,1977,580.0
2814,5,1949,1949.0,1949,483.0,0,2.0,1977,586.0
2815,5,872,872.0,872,0.0,0,1.0,1924,322.0
2816,7,1830,1865.0,1830,810.0,0,2.0,1967,521.0
2817,5,1000,1000.0,1000,104.0,0,2.0,1963,575.0
2818,5,810,782.0,810,535.0,0,2.0,1971,576.0
2819,7,1700,430.0,880,397.0,680,1.0,1980,450.0
2820,4,1350,967.0,1350,799.0,0,2.0,1954,504.0
2821,5,1150,799.0,799,230.0,351,1.0,1942,215.0
2822,6,2009,672.0,1337,0.0,672,3.0,1928,795.0
2823,6,3672,1836.0,1836,425.0,1836,2.0,1935,836.0
2824,5,1560,1776.0,1560,612.0,0,2.0,1962,528.0
2825,5,1488,0.0,1488,0.0,0,2.0,1952,569.0
2826,5,1057,1057.0,1057,0.0,0,1.0,1955,288.0
2827,6,1609,1000.0,1068,468.0,541,1.0,1953,305.0
2828,6,2559,868.0,1313,549.0,1246,2.0,1989,506.0
2829,6,1440,1344.0,1440,261.0,0,4.0,1993,920.0
2830,7,1876,1308.0,1308,0.0,568,3.0,2005,848.0
2831,7,1208,1208.0,1208,393.0,0,2.0,2005,632.0
2832,6,1846,1836.0,1846,1576.0,0,2.0,2006,495.0
2833,8,1590,1570.0,1590,1122.0,0,3.0,2005,754.0
2834,7,1809,945.0,945,0.0,864,2.0,2005,638.0
2835,7,1614,1614.0,1614,56.0,0,2.0,2005,576.0
2836,7,1596,784.0,784,0.0,812,2.0,2005,610.0
2837,6,1388,1388.0,1388,853.0,0,2.0,1968,522.0
2838,5,1100,1100.0,1100,0.0,0,2.0,1996,462.0
2839,6,1499,781.0,795,0.0,704,2.0,1995,473.0
2840,7,1425,1425.0,1425,846.0,0,2.0,1998,591.0
2841,7,1749,842.0,856,500.0,893,2.0,1999,515.0
2842,7,1779,951.0,951,894.0,828,2.0,1999,586.0
2843,6,1388,675.0,686,509.0,702,1.0,1977,317.0
2844,6,1282,995.0,1282,595.0,0,3.0,1978,672.0
2845,5,864,864.0,864,437.0,0,1.0,1972,297.0
2846,7,1762,826.0,878,456.0,884,2.0,2002,591.0
2847,6,1755,840.0,840,639.0,915,2.0,1999,530.0
2848,8,1358,1348.0,1358,872.0,0,2.0,2002,418.0
2849,7,1909,872.0,872,0.0,1037,2.0,2002,529.0
2850,8,2214,1090.0,1090,920.0,1124,3.0,1999,646.0
2851,7,2049,1065.0,1065,0.0,984,2.0,1996,467.0
2852,7,1939,1054.0,1070,796.0,869,3.0,1998,555.0
2853,7,1995,930.0,950,685.0,1045,2.0,1995,610.0
2854,6,848,848.0,848,717.0,0,2.0,2003,420.0
2855,7,1390,1390.0,1390,1000.0,0,2.0,2003,545.0
2856,7,1737,851.0,851,0.0,886,2.0,2006,578.0
2857,7,1611,784.0,784,0.0,827,2.0,2005,572.0
2858,7,1336,1336.0,1336,996.0,0,2.0,2005,502.0
2859,4,1436,676.0,760,173.0,676,2.0,1910,528.0
2860,6,1012,976.0,1012,976.0,0,0.0,1975,0.0
2861,5,1176,1176.0,1176,847.0,0,1.0,1969,360.0
2862,7,1724,796.0,806,0.0,918,2.0,2003,616.0
2863,6,914,914.0,914,475.0,0,0.0,2002,0.0
2864,7,2314,1150.0,1164,0.0,1150,2.0,2003,502.0
2865,6,1072,547.0,1072,547.0,0,2.0,2005,525.0
2866,7,1709,970.0,970,0.0,739,2.0,2004,380.0
2867,4,936,624.0,624,0.0,312,1.0,1948,265.0
2868,6,1338,832.0,846,0.0,492,2.0,1915,528.0
2869,4,1669,1093.0,1093,0.0,576,1.0,1924,288.0
2870,4,1482,954.0,1482,691.0,0,2.0,1954,609.0
2871,4,1414,864.0,964,0.0,0,0.0,1922,0.0
2872,2,498,498.0,498,0.0,0,1.0,1922,216.0
2873,4,1273,616.0,1055,0.0,218,1.0,1910,275.0
2874,5,1551,1058.0,1058,930.0,493,1.0,1938,240.0
2875,6,1340,780.0,816,780.0,524,1.0,1945,440.0
2876,7,1479,624.0,743,424.0,736,1.0,1926,312.0
2877,6,1510,755.0,755,305.0,755,1.0,1920,216.0
2878,7,1636,818.0,818,0.0,818,1.0,1919,288.0
2879,5,1465,992.0,992,646.0,473,1.0,1939,240.0
2880,5,1288,824.0,824,384.0,464,1.0,1941,240.0
2881,6,1550,817.0,940,0.0,610,1.0,1920,318.0
2882,5,1717,901.0,1125,602.0,592,1.0,1940,410.0
2883,7,1671,1022.0,1122,526.0,549,2.0,1929,451.0
2884,7,1609,637.0,959,0.0,650,3.0,1932,579.0
2885,6,1801,697.0,1104,0.0,697,2.0,1930,365.0
2886,5,2315,1168.0,1278,760.0,1037,1.0,1950,342.0
2887,5,976,976.0,976,305.0,0,1.0,1942,215.0
2888,6,1285,861.0,861,374.0,424,2.0,1926,506.0
2889,4,672,432.0,672,0.0,0,0.0,1925,0.0
2890,4,641,641.0,641,0.0,0,1.0,1925,272.0
2891,6,1638,967.0,967,0.0,671,1.0,1957,384.0
2892,3,729,0.0,729,0.0,0,0.0,1945,0.0
2893,5,1396,660.0,1060,0.0,336,0.0,1951,0.0
2894,3,936,216.0,576,0.0,360,0.0,1916,0.0
2895,8,1778,1573.0,1778,1573.0,0,2.0,2005,495.0
2896,8,1646,1594.0,1646,1564.0,0,2.0,2004,525.0
2897,6,1625,1625.0,1625,776.0,0,2.0,1979,576.0
2898,6,1664,1664.0,1664,0.0,0,2.0,1978,616.0
2899,8,1491,1491.0,1491,0.0,0,2.0,2001,490.0
2900,6,1210,1128.0,1210,576.0,0,2.0,1975,528.0
2901,6,1650,1632.0,1650,909.0,0,2.0,1958,518.0
2902,6,1403,1381.0,1403,1136.0,0,2.0,2000,470.0
2903,8,1960,1728.0,1960,1350.0,0,3.0,2005,714.0
2904,9,1838,1838.0,1838,1455.0,0,3.0,2005,682.0
2905,1,1600,0.0,1600,0.0,0,1.0,1951,270.0
2906,7,1368,1288.0,1368,1243.0,0,4.0,1997,784.0
2907,5,1304,264.0,616,0.0,688,1.0,1977,336.0
2908,5,874,864.0,874,441.0,0,1.0,1968,288.0
2909,5,1652,1652.0,1652,149.0,0,3.0,1970,928.0
2910,4,630,630.0,630,522.0,0,0.0,1970,0.0
2911,4,1092,546.0,546,252.0,546,1.0,1972,253.0
2912,5,1360,1104.0,1360,119.0,0,1.0,1969,336.0
2913,4,1092,546.0,546,408.0,546,1.0,1970,286.0
2914,4,1092,546.0,546,0.0,546,0.0,1970,0.0
2915,4,1092,546.0,546,0.0,546,0.0,1970,0.0
2916,4,1092,546.0,546,252.0,546,1.0,1970,286.0
2917,5,1224,1224.0,1224,1224.0,0,2.0,1960,576.0
2918,5,970,912.0,970,337.0,0,0.0,1992,0.0
2919,7,2000,996.0,996,758.0,1004,3.0,1993,650.0
